Team + Rank,Minutes Rank,Player,Class,Pos,School,Conf,G,MP,Totals FG,Totals FGA,Totals 2P,Totals 2PA,Totals 3P,Totals 3PA,Totals FT,Totals FTA,Totals ORB,Totals DRB,Totals TRB,Totals AST,Totals STL,Totals BLK,Totals TOV,Totals PF,Totals PTS
Abilene Christian1,1,Tevin Foster,SR,G,Abilene Christian,Southland,31,1004,116,272,71,135,45,137,105,131,19,73,92,108,44,4,83,72,382
Abilene Christian2,2,Jaylen Franklin,JR,G,Abilene Christian,Southland,31,1003,140,251,136,231,4,20,48,89,34,89,123,140,57,6,84,76,332
Abilene Christian3,3,Jaren Lewis,JR,G,Abilene Christian,Southland,31,955,153,273,140,241,13,32,90,114,73,160,233,57,48,29,70,73,409
Abilene Christian4,4,Jalone Friday,SO,C,Abilene Christian,Southland,31,687,154,337,110,211,44,126,59,84,36,121,157,16,9,45,49,107,411
Abilene Christian5,5,Payten Ricks,SO,G,Abilene Christian,Southland,25,558,50,132,25,65,25,67,38,51,6,38,44,42,18,1,31,42,163
Abilene Christian6,6,Drake Green,SR,G,Abilene Christian,Southland,31,494,46,107,15,23,31,84,6,7,2,33,35,26,15,1,24,57,129
Abilene Christian7,7,Isaiah Tripp,SR,G,Abilene Christian,Southland,27,324,26,70,13,33,13,37,11,16,4,23,27,23,16,1,15,24,76
Abilene Christian8,8,Hayden Howell,JR,F,Abilene Christian,Southland,31,306,47,84,43,75,4,9,18,30,18,41,59,9,7,4,27,54,116
Abilene Christian9,9,Hayden Farquhar,JR,F,Abilene Christian,Southland,31,298,42,111,26,41,16,70,10,17,16,61,77,11,13,9,18,40,110
Abilene Christian10,10,B.J. Maxwell,SO,G,Abilene Christian,Southland,30,283,39,83,28,54,11,29,7,14,23,37,60,19,7,10,15,50,96
Abilene Christian11,11,Trey Lenox,SO,G,Abilene Christian,Southland,28,169,7,20,7,15,0,5,2,5,3,18,21,9,13,0,10,27,16
Abilene Christian12,12,Kolton Kohl,FR,C,Abilene Christian,Southland,24,102,15,35,15,35,0,0,9,18,8,14,22,3,0,10,8,23,39
Abilene Christian13,13,Chase Cobb,SO,G,Abilene Christian,Southland,6,22,1,9,1,2,0,7,0,0,1,1,2,4,1,0,4,3,2
Abilene Christian14,14,Paul Hiepler,FR,G,Abilene Christian,Southland,4,20,2,3,1,1,1,2,0,0,1,2,3,0,1,0,1,0,5
Air Force1,1,Trevor Lyons,SR,G,Air Force,MWC,31,1012,95,242,62,153,33,89,69,94,18,128,146,102,43,2,64,67,292
Air Force2,2,Lavelle Scottie,SO,F,Air Force,MWC,31,826,145,317,108,212,37,105,50,69,46,90,136,43,22,14,68,72,377
Air Force3,3,Ryan Swan-Ford,SO,F,Air Force,MWC,31,657,102,214,81,166,21,48,61,82,53,87,140,42,19,17,35,71,286
Air Force4,4,Keaton Van Soelen,FR,G,Air Force,MWC,28,515,37,90,31,54,6,36,20,30,29,50,79,32,12,11,21,31,100
Air Force5,5,Sid Tomes,SO,G,Air Force,MWC,29,507,47,121,16,32,31,89,11,16,8,38,46,35,21,4,22,36,136
Air Force6,6,Jacob Van,SR,G,Air Force,MWC,31,481,44,123,18,52,26,71,48,54,4,32,36,35,16,2,33,30,162
Air Force7,7,Ryan Manning,SR,F,Air Force,MWC,28,446,58,152,28,53,30,99,29,38,25,59,84,15,10,5,24,35,175
Air Force8,8,Frank Toohey,SR,C,Air Force,MWC,31,426,45,107,30,70,15,37,46,55,38,43,81,26,12,8,30,65,151
Air Force9,9,C.J. Siples,SR,G,Air Force,MWC,30,421,38,97,28,48,10,49,10,18,8,32,40,45,28,5,28,47,96
Air Force10,10,Pervis Louder,JR,G,Air Force,MWC,16,291,35,92,27,55,8,37,23,35,10,29,39,28,8,3,22,37,101
Air Force11,11,Caleb Morris,SO,G,Air Force,MWC,23,278,39,90,21,38,18,52,17,24,7,45,52,20,3,2,14,27,113
Air Force12,12,Dane Norman,JR,F,Air Force,MWC,21,133,14,32,8,13,6,19,6,10,8,20,28,5,0,1,11,20,40
Air Force13,13,Jonathan DeWane,SO,F,Air Force,MWC,21,110,24,42,18,32,6,10,8,12,7,18,25,6,4,3,4,11,62
Air Force14,14,Christopher Joyce,FR,G,Air Force,MWC,10,46,2,13,1,6,1,7,1,4,3,4,7,5,1,0,1,3,6
Air Force15,15,LeSean Brown,SO,G,Air Force,MWC,14,44,3,10,3,6,0,4,8,13,2,1,3,3,0,0,1,3,14
Air Force16,16,Ameka Akaya,,F,Air Force,MWC,7,19,2,5,1,4,1,1,0,0,3,1,4,3,1,1,0,1,5
Air Force17,17,Charles O'Briant,,F,Air Force,MWC,2,4,1,1,0,0,1,1,1,2,0,1,1,0,0,0,0,1,4
Air Force18,18,Kobi Betts,,G,Air Force,MWC,1,3,0,0,0,0,0,0,0,0,0,1,1,0,0,0,0,0,0
Air Force19,19,James Edwards,,G,Air Force,MWC,1,3,1,2,1,1,0,1,0,0,0,0,0,0,1,0,0,0,2
Air Force20,20,Bryce Hughes,,G,Air Force,MWC,1,3,1,1,1,1,0,0,0,0,1,0,1,0,0,0,0,0,2
Akron1,1,Daniel Utomi,SO,F,Akron,MAC,32,1104,175,389,87,170,88,219,97,126,33,137,170,60,30,9,67,74,535
Akron2,2,Jimond Ivey,JR,G,Akron,MAC,32,1059,142,355,81,176,61,179,74,97,39,144,183,113,35,13,76,86,419
Akron3,3,Malcolm Duvivier,SR,G,Akron,MAC,32,1041,159,409,72,176,87,233,51,79,10,71,81,99,27,6,95,94,456
Akron4,4,Eric Parrish,FR,G,Akron,MAC,32,864,107,208,84,137,23,71,41,66,51,99,150,43,39,7,45,73,278
Akron5,5,Virshon Cotton,FR,G,Akron,MAC,29,595,60,163,23,65,37,98,56,74,4,54,58,51,21,0,57,42,213
Akron6,6,Torrey Patton,FR,G,Akron,MAC,32,512,39,79,36,64,3,15,26,42,37,62,99,16,15,1,21,56,107
Akron7,7,Mark Kostelac,FR,C,Akron,MAC,30,370,30,61,30,61,0,0,6,12,18,34,52,9,9,13,31,89,66
Akron8,8,Emmanuel Olojakpoke,SO,F,Akron,MAC,15,296,40,65,40,64,0,1,14,29,27,34,61,6,7,25,11,49,94
Akron9,9,Lucas Smith,,C,Akron,MAC,25,284,10,40,6,17,4,23,10,15,19,42,61,8,4,1,10,50,34
Akron10,10,Jaden Sayles,FR,F,Akron,MAC,16,234,26,40,26,40,0,0,30,41,7,22,29,4,2,5,13,15,82
Akron11,11,Sina Gbadebo,FR,G,Akron,MAC,17,76,3,8,2,3,1,5,0,1,3,4,7,6,0,0,5,7,7
Akron12,12,Craig Eubanks,SR,G,Akron,MAC,6,33,1,5,0,1,1,4,0,0,0,6,6,2,0,1,2,1,3
Akron13,13,Marquelle McIntyre,,G,Akron,MAC,10,7,1,1,1,1,0,0,0,0,0,2,2,0,0,0,1,1,2
Alabama1,1,John Petty,FR,G,Alabama,SEC,34,973,116,299,33,70,83,229,30,43,12,76,88,62,17,9,70,34,345
Alabama2,2,Dazon Ingram,SO,G,Alabama,SEC,33,952,96,224,78,159,18,65,118,169,29,157,186,86,29,11,73,89,328
Alabama3,3,Collin Sexton,FR,G,Alabama,SEC,31,924,182,410,139,285,43,125,183,234,33,84,117,110,28,3,82,75,590
Alabama4,4,Donta Hall,JR,F,Alabama,SEC,32,764,145,201,145,201,0,0,59,106,73,146,219,19,22,68,42,56,349
Alabama5,5,Herb Jones,FR,G,Alabama,SEC,33,692,55,138,48,112,7,26,22,44,26,89,115,44,43,21,51,87,139
Alabama6,6,Braxton Key,,F,Alabama,SEC,24,610,63,152,48,92,15,60,35,50,35,98,133,45,26,9,43,45,176
Alabama7,7,Avery Johnson,JR,G,Alabama,SEC,34,478,48,138,28,74,20,64,28,35,12,26,38,26,16,1,18,54,144
Alabama8,8,Daniel Giddens,SO,F,Alabama,SEC,33,440,55,96,55,96,0,0,27,47,28,57,85,8,13,35,34,93,137
Alabama9,9,Galin Smith,FR,F,Alabama,SEC,31,369,36,59,36,59,0,0,8,30,26,35,61,2,2,23,23,54,80
Alabama10,10,Alex Reese,FR,F,Alabama,SEC,30,349,44,112,22,43,22,69,8,10,21,62,83,8,14,6,21,32,118
Alabama11,11,Riley Norris,SR,G,Alabama,SEC,9,166,16,37,10,17,6,20,5,8,6,16,22,6,4,0,5,19,43
Alabama12,12,Lawson Schaffer,JR,G,Alabama,SEC,13,51,3,10,1,1,2,9,0,0,0,0,0,10,4,0,8,7,8
Alabama13,13,Landon Fuller,SO,F,Alabama,SEC,2,5,1,1,0,0,1,1,0,0,0,0,0,0,0,0,0,0,3
Alabama14,14,Tyler Barnes,,F,Alabama,SEC,3,4,0,0,0,0,0,0,0,2,0,0,0,0,0,0,0,0,0
Alabama A&M1,1,Arthur Johnson,JR,G,Alabama A&M,SWAC,31,859,119,296,72,161,47,135,57,78,46,116,162,47,22,3,79,88,342
Alabama A&M2,2,Evan Wiley,SO,F,Alabama A&M,SWAC,31,792,78,190,44,98,34,92,30,49,48,78,126,28,13,8,38,65,220
Alabama A&M3,3,Andre Kennedy,JR,F,Alabama A&M,SWAC,29,762,106,213,106,205,0,8,41,73,58,113,171,19,15,17,57,57,253
Alabama A&M4,4,De'Edrick Petty,,G,Alabama A&M,SWAC,29,704,75,221,55,125,20,96,79,102,6,55,61,49,18,3,77,51,249
Alabama A&M5,5,Julian Walters,,G,Alabama A&M,SWAC,22,672,50,120,33,64,17,56,30,43,13,86,99,80,26,0,47,44,147
Alabama A&M6,6,Marcus Merriweather,SR,G,Alabama A&M,SWAC,29,491,53,146,26,63,27,83,43,47,7,29,36,28,5,0,36,40,176
Alabama A&M7,7,Jalen Reeder,JR,G,Alabama A&M,SWAC,28,473,52,144,32,69,20,75,19,29,18,42,60,23,7,3,37,29,143
Alabama A&M8,8,Ariston Johnson,SO,G,Alabama A&M,SWAC,30,334,17,58,10,37,7,21,5,8,10,33,43,17,4,0,19,23,46
Alabama A&M9,9,Mohamed Sherif,,F,Alabama A&M,SWAC,13,309,38,87,37,85,1,2,11,37,20,30,50,9,4,4,30,42,88
Alabama A&M10,10,Tracy Burnett,SO,F,Alabama A&M,SWAC,25,304,43,102,43,101,0,1,8,15,21,31,52,7,1,5,19,20,94
Alabama A&M11,11,Mohamed Sherif,JR,F,Alabama A&M,SWAC,9,246,23,57,23,57,0,0,15,41,16,23,39,8,0,5,20,24,61
Alabama A&M12,12,Amari Goulbourne,FR,G,Alabama A&M,SWAC,10,207,14,44,8,27,6,17,6,10,3,17,20,24,7,1,15,21,40
Alabama A&M13,13,Brandon Houston,FR,F,Alabama A&M,SWAC,11,50,5,16,2,2,3,14,1,1,2,2,4,1,1,0,4,2,14
Alabama A&M14,14,Ryan McLaurin,,G,Alabama A&M,SWAC,3,12,0,3,0,2,0,1,0,0,0,0,0,0,0,0,3,0,0
Alabama A&M15,15,Terry Ellis,,G,Alabama A&M,SWAC,1,10,0,0,0,0,0,0,0,0,0,0,0,0,0,0,0,0,0
Alabama State1,1,Reginald Gee,SO,G,Alabama State,SWAC,31,931,153,350,93,202,60,148,117,151,39,105,144,31,20,14,48,63,483
Alabama State2,2,Branden Johnson,SO,C,Alabama State,SWAC,31,753,99,154,99,153,0,1,40,108,79,133,212,8,18,48,37,74,238
Alabama State3,3,Tobi Ewuosho,SO,G,Alabama State,SWAC,30,660,64,153,55,129,9,24,44,75,39,89,128,43,27,5,50,79,181
Alabama State4,4,Jacoby Ross,FR,G,Alabama State,SWAC,26,644,104,251,57,127,47,124,66,83,11,36,47,59,18,0,48,43,321
Alabama State5,5,Ed Jones,JR,F,Alabama State,SWAC,28,570,73,175,64,136,9,39,22,30,38,55,93,5,11,25,28,69,177
Alabama State6,6,Gene Davis,JR,G,Alabama State,SWAC,31,567,42,123,29,72,13,51,28,32,7,40,47,67,13,1,67,51,125
Alabama State7,7,Terrance LeFlore,SR,G,Alabama State,SWAC,31,547,59,196,46,130,13,66,24,48,21,39,60,52,28,7,42,51,155
Alabama State8,8,Rodney Simeon,,G,Alabama State,SWAC,23,440,54,169,15,46,39,123,20,25,16,28,44,6,8,4,28,43,167
Alabama State9,9,Fausto Pichardo,JR,F,Alabama State,SWAC,28,423,47,104,46,98,1,6,30,46,29,77,106,12,14,20,34,81,125
Alabama State10,10,Austin Rogers,SO,G,Alabama State,SWAC,21,235,19,45,13,30,6,15,6,11,15,22,37,14,3,2,14,37,50
Alabama State11,11,Steve Rogers,SR,G,Alabama State,SWAC,20,218,14,56,3,24,11,32,13,16,3,13,16,9,6,1,6,18,52
Alabama State12,12,Marice Wright,JR,C,Alabama State,SWAC,20,129,12,30,11,23,1,7,2,9,13,24,37,2,1,2,7,27,27
Alabama State13,13,Fredens Deneus,JR,F,Alabama State,SWAC,17,78,8,21,8,21,0,0,6,13,7,10,17,3,2,1,5,10,22
Alabama State14,14,Micah Johnson,FR,G,Alabama State,SWAC,7,30,3,10,3,8,0,2,0,0,1,4,5,3,0,0,8,1,6
Alabama-Birmingham1,1,Zack Bryant,FR,G,Alabama-Birmingham,CUSA,33,1056,162,355,132,261,30,94,94,125,15,91,106,102,37,7,73,85,448
Alabama-Birmingham2,2,Nick Norton,JR,G,Alabama-Birmingham,CUSA,32,940,81,214,29,63,52,151,29,36,9,82,91,154,39,1,52,44,243
Alabama-Birmingham3,3,Nate Darling,SO,G,Alabama-Birmingham,CUSA,33,924,113,239,53,90,60,149,44,53,14,85,99,91,14,10,67,47,330
Alabama-Birmingham4,4,Chris Cokley,SR,F,Alabama-Birmingham,CUSA,32,870,219,376,219,374,0,2,104,127,100,177,277,49,18,13,47,52,542
Alabama-Birmingham5,5,William Lee,SR,F,Alabama-Birmingham,CUSA,33,850,137,271,100,160,37,111,33,51,50,174,224,35,25,67,47,66,344
Alabama-Birmingham6,6,Jalen Perry,JR,G,Alabama-Birmingham,CUSA,33,759,80,197,49,105,31,92,55,76,26,90,116,60,21,1,45,50,246
Alabama-Birmingham7,7,Lewis Sullivan,JR,F,Alabama-Birmingham,CUSA,33,627,95,166,91,150,4,16,44,64,50,95,145,28,16,19,53,77,238
Alabama-Birmingham8,8,Makhtar Gueye,FR,F,Alabama-Birmingham,CUSA,32,303,29,61,24,38,5,23,8,12,13,38,51,7,1,4,20,48,71
Alabama-Birmingham9,9,Deion Lavender,JR,G,Alabama-Birmingham,CUSA,19,212,22,40,22,38,0,2,10,18,4,33,37,27,5,0,14,10,54
Alabama-Birmingham10,10,Thomas Smallwood,JR,F,Alabama-Birmingham,CUSA,11,82,4,17,1,11,3,6,2,2,5,9,14,3,1,4,5,8,13
Alabama-Birmingham11,11,Hunter Reynolds,FR,G,Alabama-Birmingham,CUSA,10,19,3,3,2,2,1,1,0,0,1,2,3,2,1,0,1,1,7
Alabama-Birmingham12,12,Anderson McCoy,JR,G,Alabama-Birmingham,CUSA,2,8,0,0,0,0,0,0,0,0,0,0,0,1,0,0,0,2,0
Albany (NY)1,1,Joe Cremo,JR,G,Albany (NY),AEC,32,1128,182,397,106,231,76,166,131,160,20,112,132,120,27,9,68,70,571
Albany (NY)2,2,David Nichols,JR,G,Albany (NY),AEC,32,1082,166,421,109,265,57,156,78,101,16,120,136,111,37,7,80,84,467
Albany (NY)3,3,Greig Stire,SR,F,Albany (NY),AEC,32,965,102,188,102,187,0,1,60,87,99,167,266,37,15,6,35,93,264
Albany (NY)4,4,Devonte Campbell,JR,F,Albany (NY),AEC,31,959,67,164,60,114,7,50,66,85,44,70,114,53,16,18,37,57,207
Albany (NY)5,5,Travis Charles,SR,F,Albany (NY),AEC,31,896,174,314,174,314,0,0,106,129,60,115,175,22,17,13,55,87,454
Albany (NY)6,6,Alex Foster,SR,F,Albany (NY),AEC,32,482,59,110,59,109,0,1,30,58,54,97,151,8,13,30,35,70,148
Albany (NY)7,7,Costa Anderson,SR,G,Albany (NY),AEC,29,325,32,90,9,22,23,68,7,9,5,21,26,21,8,0,10,9,94
Albany (NY)8,8,Ahmad Clark,SO,G,Albany (NY),AEC,29,308,31,91,13,48,18,43,26,34,6,27,33,26,15,3,27,33,106
Albany (NY)9,9,Matt Conway,SO,F,Albany (NY),AEC,23,200,22,49,19,35,3,14,7,13,12,14,26,6,1,5,8,19,54
Albany (NY)10,10,Xavier Cochran,SO,G,Albany (NY),AEC,13,51,3,9,3,7,0,2,2,4,0,3,3,1,1,0,4,6,8
Albany (NY)11,11,Nick Fruscio,SO,G,Albany (NY),AEC,5,6,1,3,1,2,0,1,0,0,0,0,0,0,0,0,1,0,2
Alcorn State1,1,A.J. Mosby,SR,G,Alcorn State,SWAC,32,1030,178,354,120,209,58,145,71,82,14,136,150,124,46,4,64,56,485
Alcorn State2,2,Maurice Howard,SO,G,Alcorn State,SWAC,32,891,114,308,40,101,74,207,29,41,17,62,79,64,26,0,53,56,331
Alcorn State3,3,Dante Sterling,,F,Alcorn State,SWAC,32,867,116,299,58,137,58,162,87,107,21,84,105,48,31,4,67,46,377
Alcorn State4,4,Devon Brewer,SO,F,Alcorn State,SWAC,31,717,76,137,76,137,0,0,30,65,26,103,129,25,8,22,48,86,182
Alcorn State5,5,Troymain Crosby,FR,G,Alcorn State,SWAC,32,622,88,199,85,166,3,33,59,80,46,92,138,22,22,6,68,92,238
Alcorn State6,6,Yalen Reed,SO,F,Alcorn State,SWAC,28,589,65,129,60,106,5,23,37,59,44,89,133,28,7,28,31,77,172
Alcorn State7,7,Avery Patterson,SR,G,Alcorn State,SWAC,25,510,45,123,26,63,19,60,40,54,13,39,52,53,14,1,43,47,149
Alcorn State8,8,Tyler Carter,SO,F,Alcorn State,SWAC,32,505,37,98,32,78,5,20,39,53,43,69,112,22,20,2,31,81,118
Alcorn State9,9,Kobe Wilson,FR,F,Alcorn State,SWAC,27,209,8,27,6,19,2,8,8,20,12,39,51,8,6,10,9,28,26
Alcorn State10,10,Reginald Johnson,SR,F,Alcorn State,SWAC,8,184,39,87,29,53,10,34,10,16,16,18,34,9,7,1,8,12,98
Alcorn State11,11,TyQuayion Smith,JR,F,Alcorn State,SWAC,20,112,7,14,6,11,1,3,5,7,6,10,16,2,5,4,8,10,20
Alcorn State12,12,Khari Jabriel Allen,JR,G,Alcorn State,SWAC,5,88,8,26,5,17,3,9,5,6,1,4,5,3,0,2,10,9,24
Alcorn State13,13,James Stokes,SR,G,Alcorn State,SWAC,12,53,5,13,5,13,0,0,1,5,1,8,9,2,5,1,1,7,11
Alcorn State14,14,Juwan Henderson,SR,G,Alcorn State,SWAC,6,48,5,12,4,8,1,4,2,3,2,2,4,9,3,0,7,6,13
American1,1,Laurynas Motuzis,JR,G,American,Patriot,30,1083,155,373,92,183,63,190,65,102,22,121,143,50,49,7,66,85,438
American2,2,Sa'eed Nelson,,G,American,Patriot,29,1074,191,431,163,335,28,96,128,188,25,79,104,147,52,5,109,77,538
American3,3,Sam Iorio,FR,F,American,Patriot,28,934,143,300,81,158,62,142,68,86,46,137,183,37,38,25,49,72,416
American4,4,Cheikh Diallo,JR,G,American,Patriot,30,723,57,137,24,37,33,100,12,17,14,55,69,28,17,2,47,64,159
American5,5,Marvin Bragg,FR,G,American,Patriot,27,579,46,93,26,39,20,54,15,29,18,62,80,26,18,12,19,60,127
American6,6,Jesse Little,FR,F,American,Patriot,23,433,26,49,25,43,1,6,14,27,33,42,75,19,11,21,23,62,67
American7,7,Stacy Beckton,,G,American,Patriot,20,365,31,105,21,56,10,49,15,21,13,29,42,17,9,11,26,34,87
American8,8,Drew LaMont,FR,F,American,Patriot,14,245,16,45,3,9,13,36,4,8,5,18,23,13,7,6,10,18,49
American9,9,Nick Macarchuk,FR,F,American,Patriot,18,212,8,12,7,11,1,1,1,4,12,11,23,13,8,2,10,37,18
American10,10,Matt Cimino,JR,F,American,Patriot,18,190,11,27,8,13,3,14,0,2,10,23,33,12,2,6,20,25,25
American11,11,James Washington,JR,G,American,Patriot,15,175,13,38,9,20,4,18,4,7,2,13,15,5,6,1,13,13,34
American12,12,Kevin Brown,JR,G,American,Patriot,6,10,0,4,0,2,0,2,0,0,0,2,2,0,0,0,2,3,0
American13,13,Tyler McFarland,,G,American,Patriot,2,2,1,1,0,0,1,1,0,0,0,1,1,0,0,0,0,0,3
Appalachian State1,1,Ronshad Shabazz,JR,G,Appalachian State,Sun Belt,33,1079,206,515,126,282,80,233,117,170,19,64,83,99,36,2,80,58,609
Appalachian State2,2,Justin Forrest,FR,G,Appalachian State,Sun Belt,33,924,147,399,81,180,66,219,84,126,10,85,95,65,43,2,95,86,444
Appalachian State3,3,Isaac Johnson,SO,F,Appalachian State,Sun Belt,33,908,77,158,71,132,6,26,81,129,84,193,277,49,29,16,52,76,241
Appalachian State4,4,O'Showen Williams,,G,Appalachian State,Sun Belt,33,825,82,201,38,86,44,115,50,74,24,50,74,78,36,3,43,51,258
Appalachian State5,5,Griffin Kinney,SR,F,Appalachian State,Sun Belt,33,779,130,223,127,214,3,9,85,116,53,131,184,43,19,11,65,101,348
Appalachian State6,6,Tyrell Johnson,JR,F,Appalachian State,Sun Belt,33,731,88,211,57,112,31,99,37,54,37,98,135,19,8,37,39,79,244
Appalachian State7,7,Craig Hinton,SR,F,Appalachian State,Sun Belt,33,613,59,122,26,35,33,87,15,24,34,81,115,16,7,20,28,65,166
Appalachian State8,8,Hunter Seacat,,F,Appalachian State,Sun Belt,22,246,26,46,26,46,0,0,6,9,16,39,55,12,4,10,13,32,58
Appalachian State9,9,Bennett Holley,JR,F,Appalachian State,Sun Belt,29,199,18,45,3,6,15,39,4,4,8,20,28,7,2,3,4,32,55
Appalachian State10,10,Zach Cottrell,SO,F,Appalachian State,Sun Belt,23,176,9,28,3,6,6,22,3,6,7,27,34,9,5,0,5,20,27
Appalachian State11,11,Jake Wilson,JR,C,Appalachian State,Sun Belt,26,159,10,17,10,17,0,0,11,25,21,37,58,4,3,12,14,20,31
Appalachian State12,12,Nick Hough,JR,G,Appalachian State,Sun Belt,7,21,5,8,3,4,2,4,0,0,2,4,6,1,3,0,3,2,12
Appalachian State13,13,Trey Ford,JR,G,Appalachian State,Sun Belt,6,20,4,5,1,1,3,4,4,5,1,4,5,1,1,0,2,2,15
Appalachian State14,14,Kevin Kerley,JR,G,Appalachian State,Sun Belt,7,20,3,5,0,2,3,3,3,6,0,0,0,5,2,0,2,2,12
Arizona1,1,DeAndre Ayton,FR,F,Arizona,Pac-12,34,1134,270,438,258,405,12,33,138,186,113,279,392,56,19,65,68,81,690
Arizona2,2,Allonzo Trier,JR,G,Arizona,Pac-12,32,1093,180,354,110,175,70,179,158,183,11,88,99,105,21,11,67,55,588
Arizona3,3,Parker Jackson-Cartwright,SR,G,Arizona,Pac-12,34,1086,87,197,38,81,49,116,44,58,8,72,80,156,49,4,63,76,267
Arizona4,4,Dusan Ristic,SR,C,Arizona,Pac-12,34,923,171,305,165,291,6,14,62,79,70,169,239,31,13,17,45,79,410
Arizona5,5,Rawle Alkins,,G,Arizona,Pac-12,22,688,95,220,62,130,33,90,71,98,41,64,105,53,27,16,57,48,294
Arizona6,6,Dylan Smith,SO,G,Arizona,Pac-12,33,494,49,134,17,38,32,96,17,21,12,41,53,35,5,7,31,49,147
Arizona7,7,Brandon Randolph,FR,G,Arizona,Pac-12,30,352,40,105,26,60,14,45,19,26,4,21,25,25,12,4,21,37,113
Arizona8,8,Keanu Pinder,SR,F,Arizona,Pac-12,31,321,24,36,24,36,0,0,21,34,13,52,65,2,8,16,13,61,69
Arizona9,9,Emmanuel Akot,FR,G,Arizona,Pac-12,30,312,21,51,12,29,9,22,5,11,11,23,34,25,6,3,19,26,56
Arizona10,10,Ira Lee,FR,F,Arizona,Pac-12,26,275,23,51,22,49,1,2,13,23,19,42,61,10,5,12,13,50,60
Arizona11,11,Alex Barcello,FR,G,Arizona,Pac-12,21,202,18,46,10,20,8,26,6,8,3,19,22,19,3,0,8,26,50
Arizona12,12,Jake Desjardins,SO,F,Arizona,Pac-12,3,7,1,2,1,2,0,0,0,0,0,3,3,1,0,0,1,2,2
Arizona13,13,Talbott Denny,SR,F,Arizona,Pac-12,3,6,0,0,0,0,0,0,1,2,0,0,0,0,0,0,1,1,1
Arizona14,14,Tyler Trillo,JR,G,Arizona,Pac-12,2,6,1,1,0,0,1,1,0,0,0,0,0,0,0,0,1,1,3
Arizona15,15,Matt Weyand,,F,Arizona,Pac-12,1,1,0,0,0,0,0,0,0,0,0,0,0,0,0,0,0,0,0
Arizona State1,1,Tra Holder,SR,G,Arizona State,Pac-12,31,1073,174,421,107,242,67,179,159,189,28,100,128,106,41,1,74,63,574
Arizona State2,2,Shannon Evans,SR,G,Arizona State,Pac-12,31,1052,151,399,60,155,91,244,122,143,10,89,99,109,44,9,52,58,515
Arizona State3,3,Kodi Justice,SR,G,Arizona State,Pac-12,31,1001,137,300,63,106,74,194,42,63,8,75,83,60,37,6,46,60,390
Arizona State4,4,Remy Martin,FR,G,Arizona State,Pac-12,31,718,106,232,84,174,22,58,71,94,21,68,89,90,36,2,42,47,305
Arizona State5,5,Romello White,FR,F,Arizona State,Pac-12,30,709,119,182,119,182,0,0,83,149,77,139,216,13,8,23,44,98,321
Arizona State6,6,De'Quon Lake,,F,Arizona State,Pac-12,31,570,90,126,90,126,0,0,47,71,58,106,164,4,8,40,14,89,227
Arizona State7,7,Mickey Mitchell,,F,Arizona State,Pac-12,23,535,46,93,40,74,6,19,32,47,34,88,122,38,19,13,32,69,130
Arizona State8,8,Vitaliy Shibel,FR,F,Arizona State,Pac-12,31,346,19,55,8,11,11,44,10,12,11,46,57,15,4,9,15,69,59
Arizona State9,9,Kimani Lawrence,,F,Arizona State,Pac-12,18,186,22,48,19,33,3,15,11,13,10,23,33,3,7,8,9,29,58
Arizona State10,10,Austin Witherill,SR,G,Arizona State,Pac-12,15,40,3,6,0,0,3,6,1,2,1,4,5,0,0,0,0,0,10
Arizona State11,11,Grant Fogerty,SO,G,Arizona State,Pac-12,12,12,0,2,0,1,0,1,0,0,0,0,0,1,0,0,0,3,0
Arizona State12,12,Jordan Salzman,FR,G,Arizona State,Pac-12,8,8,0,3,0,3,0,0,0,0,0,0,0,0,0,0,0,0,0
Arkansas1,1,Jaylen Barford,SR,G,Arkansas,SEC,34,1061,220,466,135,270,85,196,88,123,35,100,135,87,35,10,64,86,613
Arkansas2,2,Daryl Macon,SR,G,Arkansas,SEC,34,1048,171,379,87,183,84,196,149,171,13,85,98,134,34,2,62,61,575
Arkansas3,3,Anton Beard,SR,G,Arkansas,SEC,34,1026,109,282,71,167,38,115,69,94,20,70,90,105,32,2,44,87,325
Arkansas4,4,Daniel Gafford,FR,F,Arkansas,SEC,34,769,162,262,162,262,0,0,82,157,74,137,211,24,19,73,37,112,406
Arkansas5,5,Trey Thompson,SR,F,Arkansas,SEC,34,611,48,95,48,95,0,0,17,28,39,94,133,52,22,28,34,75,113
Arkansas6,6,C.J. Jones,SO,G,Arkansas,SEC,34,506,79,184,37,71,42,113,18,22,4,45,49,14,8,4,13,30,218
Arkansas7,7,Dustin Thomas,SR,F,Arkansas,SEC,26,500,48,94,47,91,1,3,34,51,31,76,107,26,20,3,29,69,131
Arkansas8,8,Darious Hall,FR,F,Arkansas,SEC,34,497,62,121,49,91,13,30,36,64,31,75,106,16,16,7,37,69,173
Arkansas9,9,Adrio Bailey,SO,F,Arkansas,SEC,30,419,50,93,50,93,0,0,20,33,28,49,77,16,15,23,18,58,120
Arkansas10,10,Arlando Cook,,F,Arkansas,SEC,27,279,20,47,20,47,0,0,6,15,13,34,47,10,7,2,10,17,46
Arkansas11,11,Gabe Osabuohien,FR,F,Arkansas,SEC,19,135,10,25,10,21,0,4,2,10,6,22,28,7,3,3,11,21,22
Arkansas12,12,Jonathan Holmes,SO,G,Arkansas,SEC,11,18,6,15,4,9,2,6,1,2,2,1,3,1,1,0,2,1,15
Arkansas13,13,Jt Plummer,,G,Arkansas,SEC,6,6,0,0,0,0,0,0,0,0,0,0,0,0,0,0,0,0,0
Arkansas State1,1,Ty Cockfield,JR,G,Arkansas State,Sun Belt,32,955,171,385,117,236,54,149,83,105,25,66,91,64,29,4,69,61,479
Arkansas State2,2,Rashad Lindsey,SR,G,Arkansas State,Sun Belt,32,947,103,251,73,162,30,89,47,56,20,49,69,78,28,1,47,51,283
Arkansas State3,3,Deven Simms,SR,G,Arkansas State,Sun Belt,24,736,146,308,116,228,30,80,88,120,29,116,145,41,33,10,65,41,410
Arkansas State4,4,Tamas Bruce,SR,F,Arkansas State,Sun Belt,30,672,103,193,103,192,0,1,62,98,81,89,170,12,22,21,46,108,268
Arkansas State5,5,Tristin Walley,JR,F,Arkansas State,Sun Belt,30,656,70,173,41,91,29,82,38,55,47,84,131,16,26,20,43,59,207
Arkansas State6,6,Grantham Gillard,JR,G,Arkansas State,Sun Belt,30,653,85,217,37,65,48,152,44,62,27,80,107,23,26,3,25,60,262
Arkansas State7,7,Marquis Eaton,FR,G,Arkansas State,Sun Belt,32,641,69,176,56,129,13,47,43,52,10,41,51,68,26,6,50,52,194
Arkansas State8,8,Connor Kern,SO,G,Arkansas State,Sun Belt,32,526,39,105,12,27,27,78,14,20,8,38,46,24,13,4,24,44,119
Arkansas State9,9,Salif Boudie,SO,F,Arkansas State,Sun Belt,25,354,34,48,34,48,0,0,21,37,36,68,104,4,8,22,20,53,89
Arkansas State10,10,Jake Scoggins,FR,F,Arkansas State,Sun Belt,25,156,11,24,11,24,0,0,2,8,7,20,27,3,3,1,8,35,24
Arkansas State11,11,C.J. Foster,SR,G,Arkansas State,Sun Belt,8,111,5,16,2,5,3,11,5,10,1,11,12,6,0,1,11,14,18
Arkansas State12,12,Andrew Riley,SR,G,Arkansas State,Sun Belt,7,18,5,11,3,6,2,5,0,0,2,1,3,2,0,0,0,2,12
Arkansas State13,13,Shaquillo Fritz,JR,F,Arkansas State,Sun Belt,6,16,0,0,0,0,0,0,2,2,0,5,5,0,0,1,1,9,2
Arkansas State14,14,Christian Willis,SO,G,Arkansas State,Sun Belt,2,8,1,3,1,2,0,1,0,0,1,0,1,0,1,0,1,0,2
Arkansas-Little Rock1,1,Oliver Black,JR,F,Arkansas-Little Rock,Sun Belt,31,856,75,156,75,155,0,1,46,87,74,137,211,35,9,19,44,87,196
Arkansas-Little Rock2,2,Jaizec Lottie,FR,G,Arkansas-Little Rock,Sun Belt,32,801,77,209,57,136,20,73,53,92,12,74,86,93,33,1,70,70,227
Arkansas-Little Rock3,3,Andre Jones,SO,G,Arkansas-Little Rock,Sun Belt,23,666,115,291,103,217,12,74,40,60,25,80,105,55,11,4,52,42,282
Arkansas-Little Rock4,4,Anthony Black,JR,G,Arkansas-Little Rock,Sun Belt,27,573,78,177,45,83,33,94,8,11,12,51,63,43,26,3,26,44,197
Arkansas-Little Rock5,5,Cameron Corcoran,FR,G,Arkansas-Little Rock,Sun Belt,31,516,63,151,17,43,46,108,35,45,4,16,20,28,9,1,29,18,207
Arkansas-Little Rock6,6,Ben Marcus,JR,G,Arkansas-Little Rock,Sun Belt,30,495,77,114,77,114,0,0,24,59,38,68,106,18,17,9,38,66,178
Arkansas-Little Rock7,7,Ryan Pippins,,G,Arkansas-Little Rock,Sun Belt,19,465,47,131,24,77,23,54,27,36,3,38,41,25,12,0,28,39,144
Arkansas-Little Rock8,8,Kris Bankston,FR,F,Arkansas-Little Rock,Sun Belt,30,450,48,77,48,76,0,1,25,55,33,86,119,16,8,30,26,67,121
Arkansas-Little Rock9,9,Camron Reedus,JR,G,Arkansas-Little Rock,Sun Belt,22,410,49,118,17,35,32,83,29,35,6,33,39,13,14,1,31,37,159
Arkansas-Little Rock10,10,Damir Hadzic,FR,F,Arkansas-Little Rock,Sun Belt,26,349,36,95,20,38,16,57,18,26,18,35,53,23,6,4,25,50,106
Arkansas-Little Rock11,11,K.J. Gilmore,JR,G,Arkansas-Little Rock,Sun Belt,27,334,31,99,28,82,3,17,9,10,9,20,29,26,5,2,24,25,74
Arkansas-Little Rock12,12,Wadly Mompremier,SR,F,Arkansas-Little Rock,Sun Belt,24,329,37,76,28,47,9,29,19,29,22,53,75,7,6,19,37,47,102
Arkansas-Little Rock13,13,Brandon Brady,SR,G,Arkansas-Little Rock,Sun Belt,14,134,11,29,6,9,5,20,3,5,1,10,11,7,2,0,4,8,30
Arkansas-Little Rock14,14,Cezanne Carson,JR,F,Arkansas-Little Rock,Sun Belt,13,76,4,16,4,9,0,7,0,0,2,9,11,2,1,0,2,0,8
Arkansas-Little Rock15,15,Khari Harley,SR,G,Arkansas-Little Rock,Sun Belt,7,46,2,15,1,10,1,5,2,3,2,2,4,0,0,0,5,12,7
Arkansas-Pine Bluff1,1,Martaveous McKnight,JR,G,Arkansas-Pine Bluff,SWAC,35,1194,217,480,153,298,64,182,152,210,16,134,150,124,68,5,92,31,650
Arkansas-Pine Bluff2,2,Charles Jackson,JR,G,Arkansas-Pine Bluff,SWAC,35,1036,98,286,42,92,56,194,52,78,24,81,105,78,38,12,75,85,304
Arkansas-Pine Bluff3,3,Travon Harper,SR,F,Arkansas-Pine Bluff,SWAC,35,818,140,251,129,220,11,31,80,113,59,108,167,25,20,30,55,118,371
Arkansas-Pine Bluff4,4,Joe'Randle Toliver,,G,Arkansas-Pine Bluff,SWAC,35,701,69,174,8,13,61,161,10,17,12,75,87,60,28,2,32,35,209
Arkansas-Pine Bluff5,5,Trent Steen,SR,F,Arkansas-Pine Bluff,SWAC,34,697,107,231,105,222,2,9,42,65,26,88,114,17,29,45,60,112,258
Arkansas-Pine Bluff6,6,Cameron Posey,FR,G,Arkansas-Pine Bluff,SWAC,33,572,30,94,18,55,12,39,26,32,14,33,47,31,20,2,53,46,98
Arkansas-Pine Bluff7,7,Quamauri Hardy,FR,G,Arkansas-Pine Bluff,SWAC,34,549,38,100,31,80,7,20,17,27,15,23,38,45,33,0,36,59,100
Arkansas-Pine Bluff8,8,Christian Robertson,JR,F,Arkansas-Pine Bluff,SWAC,35,412,29,77,29,70,0,7,18,31,23,31,54,15,7,0,19,37,76
Arkansas-Pine Bluff9,9,Terrance Banyard,FR,F,Arkansas-Pine Bluff,SWAC,30,381,55,93,54,91,1,2,48,79,28,55,83,7,6,23,24,54,159
Arkansas-Pine Bluff10,10,Artavious McDyess,SO,F,Arkansas-Pine Bluff,SWAC,18,221,10,20,10,20,0,0,6,10,19,30,49,1,7,17,12,35,26
Arkansas-Pine Bluff11,11,David Tillman,SR,C,Arkansas-Pine Bluff,SWAC,21,136,5,9,5,9,0,0,3,7,7,9,16,2,2,7,8,38,13
Arkansas-Pine Bluff12,12,J'Breun Sprinkle,,G,Arkansas-Pine Bluff,SWAC,17,96,4,9,3,7,1,2,1,3,1,2,3,7,3,0,4,6,10
Arkansas-Pine Bluff13,13,Kennedy McKinney,SR,G,Arkansas-Pine Bluff,SWAC,17,94,9,25,9,19,0,6,1,2,2,8,10,8,10,1,9,9,19
Arkansas-Pine Bluff14,14,William Ridgell,,G,Arkansas-Pine Bluff,SWAC,12,66,1,3,1,3,0,0,0,0,0,5,5,2,0,0,2,4,2
Arkansas-Pine Bluff15,15,Dwain Whitfield,JR,F,Arkansas-Pine Bluff,SWAC,10,45,2,5,1,2,1,3,1,2,5,1,6,3,0,0,2,7,6
Arkansas-Pine Bluff16,16,Marcus Wallace,JR,G,Arkansas-Pine Bluff,SWAC,5,22,0,1,0,1,0,0,2,2,1,2,3,0,0,0,0,1,2
Arkansas-Pine Bluff17,17,Jordan McNair,,G,Arkansas-Pine Bluff,SWAC,2,10,1,5,0,1,1,4,1,3,0,0,0,2,3,0,1,4,4
Army1,1,Thomas Funk,SO,G,Army,Patriot,30,904,119,279,85,189,34,90,51,73,18,76,94,171,23,1,66,57,323
Army2,2,Jordan Fox,JR,G,Army,Patriot,30,898,139,343,61,146,78,197,55,68,19,104,123,126,23,3,62,76,411
Army3,3,Matthew Wilson,SO,F,Army,Patriot,30,739,157,263,157,263,0,0,46,90,54,116,170,15,8,7,50,72,360
Army4,4,Jacob Kessler,JR,G,Army,Patriot,30,689,59,134,50,81,9,53,29,40,47,75,122,54,20,12,30,65,156
Army5,5,Luke Morrison,SR,F,Army,Patriot,30,588,91,219,26,62,65,157,11,15,23,89,112,29,9,0,23,58,258
Army6,6,Alex King,FR,F,Army,Patriot,30,585,98,221,56,129,42,92,41,59,21,83,104,23,19,18,52,75,279
Army7,7,Tucker Blackwell,FR,G,Army,Patriot,29,494,59,148,26,66,33,82,24,38,9,35,44,32,22,2,25,50,175
Army8,8,John Emezie,JR,G,Army,Patriot,29,414,41,103,23,57,18,46,11,21,16,34,50,24,20,11,24,32,111
Army9,9,Babacar Thiombane,FR,F,Army,Patriot,30,281,16,27,16,27,0,0,5,15,24,59,83,10,14,19,23,59,37
Army10,10,Lonnie Grayson,FR,G,Army,Patriot,22,204,21,64,8,25,13,39,11,12,3,19,22,7,5,3,16,23,66
Army11,11,John Miller,JR,C,Army,Patriot,21,127,11,17,11,17,0,0,4,8,11,17,28,3,4,5,8,18,26
Army12,12,Mark Madden,FR,G,Army,Patriot,7,27,1,3,1,2,0,1,2,2,1,2,3,1,1,0,1,2,4
Army13,13,Parker Fennema,JR,F,Army,Patriot,5,19,2,6,1,2,1,4,1,2,0,3,3,1,0,1,1,2,6
Army14,14,Mark Pollack,SR,F,Army,Patriot,6,16,2,10,0,2,2,8,0,0,0,2,2,0,0,1,1,2,6
Army15,15,Cayne Edwards,JR,G,Army,Patriot,5,16,3,4,3,4,0,0,4,5,2,5,7,1,2,0,1,1,10
Army16,16,Jason Houle,JR,G,Army,Patriot,2,7,0,2,0,1,0,1,0,0,0,1,1,0,0,0,1,0,0
Army17,17,Lance Lawson,SO,G,Army,Patriot,2,6,0,0,0,0,0,0,0,0,0,0,0,3,0,0,0,1,0
Army18,18,Keeston Smith,SO,F,Army,Patriot,1,4,0,0,0,0,0,0,0,0,0,1,1,0,0,0,0,0,0
Army19,19,Nick Finke,FR,F,Army,Patriot,1,4,0,0,0,0,0,0,0,0,0,0,0,0,0,0,0,0,0
Army20,20,Will Culliton,SO,G,Army,Patriot,1,4,1,2,1,1,0,1,0,0,0,1,1,0,0,0,1,0,2
Auburn1,1,Jared Harper,SO,G,Auburn,SEC,32,990,108,289,49,127,59,162,163,196,13,64,77,182,38,1,69,57,438
Auburn2,2,Bryce Brown,JR,G,Auburn,SEC,31,967,162,397,61,136,101,261,77,97,17,45,62,54,31,7,42,54,502
Auburn3,3,Mustapha Heron,SO,G,Auburn,SEC,30,855,163,367,121,244,42,123,130,161,41,123,164,27,35,2,61,76,498
Auburn4,4,DeSean Murray,JR,F,Auburn,SEC,32,756,108,231,91,181,17,50,98,115,86,133,219,57,28,19,60,74,331
Auburn5,5,Chuma Okeke,FR,F,Auburn,SEC,32,682,89,188,56,108,33,80,35,51,66,114,180,34,23,21,26,59,246
Auburn6,6,Davion Mitchell,FR,G,Auburn,SEC,32,544,42,97,27,48,15,49,21,29,9,29,38,61,16,1,38,68,120
Auburn7,7,Horace Spencer,JR,F,Auburn,SEC,32,539,53,97,53,96,0,1,37,51,47,107,154,24,36,40,33,95,143
Auburn8,8,Anfernee McLemore,SO,F,Auburn,SEC,27,525,74,139,56,93,18,46,35,48,49,93,142,14,20,73,24,70,201
Auburn9,9,Malik Dunbar,JR,G,Auburn,SEC,32,456,66,160,40,86,26,74,16,27,17,61,78,8,11,8,27,64,174
Auburn10,10,Patrick Keim,SR,G,Auburn,SEC,11,19,1,2,0,0,1,2,1,4,0,2,2,0,0,0,4,6,4
Auburn11,11,Cole Blackstock,JR,F,Auburn,SEC,12,17,0,0,0,0,0,0,4,4,0,4,4,0,0,1,0,5,4
Auburn12,12,Will Macoy,SO,G,Auburn,SEC,9,15,0,5,0,2,0,3,2,4,1,2,3,0,0,0,0,2,2
Auburn13,13,Brett Easterling,FR,G,Auburn,SEC,8,14,1,2,1,1,0,1,0,0,0,1,1,0,0,0,1,1,2
Auburn14,14,Devontae Williams,SO,G,Auburn,SEC,7,10,0,1,0,1,0,0,1,2,0,1,1,1,0,0,2,1,1
Auburn15,15,Thomas Collier,SO,F,Auburn,SEC,5,10,1,2,1,2,0,0,0,0,0,2,2,0,0,0,1,3,2
Austin Peay1,1,Terry Taylor,FR,G,Austin Peay,OVC,32,999,177,328,141,249,36,79,98,135,121,143,264,24,18,32,58,82,488
Austin Peay2,2,Averyl Ugba,SR,F,Austin Peay,OVC,32,952,185,339,171,303,14,36,109,157,95,161,256,31,13,35,73,94,493
Austin Peay3,3,Tre' Ivory,,G,Austin Peay,OVC,32,837,42,158,35,119,7,39,36,67,17,48,65,124,36,1,60,77,127
Austin Peay4,4,Dayton Gumm,FR,G,Austin Peay,OVC,31,810,118,277,77,162,41,115,48,82,26,60,86,57,37,0,54,61,325
Austin Peay5,5,Chris Porter-Bunton,JR,F,Austin Peay,OVC,32,773,83,199,59,128,24,71,52,72,38,104,142,58,39,3,61,111,242
Austin Peay6,6,Zach Glotta,JR,PG,Austin Peay,OVC,32,715,84,221,29,64,55,157,45,55,12,42,54,76,28,0,29,63,268
Austin Peay7,7,Steve Harris,JR,G,Austin Peay,OVC,32,634,86,188,80,169,6,19,34,53,20,35,55,28,21,9,52,58,212
Austin Peay8,8,Richard Henderson,FR,F,Austin Peay,OVC,30,316,44,82,44,82,0,0,20,50,24,46,70,5,7,11,21,44,108
Austin Peay9,9,Ivan Cucak,FR,C,Austin Peay,OVC,22,128,9,15,8,14,1,1,2,5,3,5,8,4,3,2,15,24,21
Austin Peay10,10,Acoydan McCarthy,FR,G,Austin Peay,OVC,22,105,7,20,6,16,1,4,3,9,1,11,12,5,2,1,6,8,18
Austin Peay11,11,Edward Stephens,,G,Austin Peay,OVC,9,88,8,24,3,8,5,16,2,2,1,5,6,3,1,0,4,6,23
Austin Peay12,12,Deyshawn Martin,JR,G,Austin Peay,OVC,6,62,7,15,5,7,2,8,5,7,2,10,12,3,4,4,6,9,21
Austin Peay13,13,Ferran Bernacer,FR,G,Austin Peay,OVC,7,31,2,10,1,2,1,8,0,0,1,3,4,3,2,0,4,4,5
Ball State1,1,Tayler Persons,JR,G,Ball State,MAC,32,953,187,406,149,304,38,102,69,103,17,90,107,137,26,5,94,78,481
Ball State2,2,Kyle Mallers,SO,F,Ball State,MAC,32,890,98,215,64,114,34,101,77,90,65,93,158,41,18,13,42,81,307
Ball State3,3,Sean Sellers,SR,G,Ball State,MAC,32,865,91,216,34,63,57,153,27,33,26,112,138,37,20,12,34,58,266
Ball State4,4,Trey Moses,JR,C,Ball State,MAC,32,836,134,235,134,234,0,1,93,155,81,180,261,66,15,27,71,76,361
Ball State5,5,Tahjai Teague,SO,F,Ball State,MAC,32,816,149,281,142,235,7,46,81,124,58,183,241,39,38,28,47,82,386
Ball State6,6,Ishmael El-Amin,FR,G,Ball State,MAC,31,579,52,141,34,85,18,56,29,40,7,55,62,47,17,3,39,39,151
Ball State7,7,Francis Kiapway,SR,G,Ball State,MAC,25,429,25,98,2,14,23,84,15,18,3,27,30,18,6,3,17,31,88
Ball State8,8,Zach Gunn,FR,F,Ball State,MAC,25,352,40,110,17,38,23,72,21,27,12,58,70,18,5,9,24,53,124
Ball State9,9,Jontrell Walker,JR,G,Ball State,MAC,14,318,35,84,16,34,19,50,21,26,3,15,18,30,8,3,24,22,110
Ball State10,10,Jeremie Tyler,SR,G,Ball State,MAC,15,274,37,88,15,39,22,49,10,15,5,18,23,14,13,9,18,13,106
Ball State11,11,Josh Thompson,SO,G,Ball State,MAC,16,152,7,20,3,7,4,13,10,12,1,9,10,5,4,0,6,15,28
Ball State12,12,Tyler Leedy,FR,G,Ball State,MAC,4,6,1,1,1,1,0,0,0,0,0,0,0,1,0,0,0,0,2
Ball State13,13,Blake Huggins,,C,Ball State,MAC,1,4,0,0,0,0,0,0,0,0,0,0,0,0,0,0,0,0,0
Baylor1,1,Manu Lecomte,SR,G,Baylor,Big 12,31,1053,150,377,64,149,86,228,111,125,6,62,68,109,22,0,65,59,497
Baylor2,2,Jo Acuil,SR,F,Baylor,Big 12,31,965,176,345,170,325,6,20,77,106,88,186,274,23,17,58,66,88,435
Baylor3,3,King McClure,JR,G,Baylor,Big 12,32,766,88,224,50,113,38,111,48,62,15,63,78,52,30,1,48,74,262
Baylor4,4,Jake Lindsey,JR,G,Baylor,Big 12,32,761,56,122,42,79,14,43,23,35,13,71,84,105,34,12,41,85,149
Baylor5,5,Nuni Omot,SR,F,Baylor,Big 12,32,755,101,209,52,96,49,113,62,73,30,89,119,55,17,9,47,48,313
Baylor6,6,Mark Vital,FR,F,Baylor,Big 12,31,740,85,175,84,167,1,8,45,89,70,102,172,67,26,21,66,69,216
Baylor7,7,Tristan Clark,FR,F,Baylor,Big 12,32,647,90,150,88,143,2,7,36,55,46,99,145,25,17,27,35,79,218
Baylor8,8,T.J. Maston,SR,F,Baylor,Big 12,26,578,120,231,117,216,3,15,38,49,59,86,145,16,9,8,39,43,281
Baylor9,9,Tyson Jolly,,G,Baylor,Big 12,18,164,9,40,7,21,2,19,7,10,9,24,33,16,4,4,11,31,27
Baylor10,10,Jonathan Davis,JR,F,Baylor,Big 12,9,27,4,9,2,3,2,6,1,1,0,1,1,2,0,0,2,3,11
Baylor11,11,Obim Okeke,,G,Baylor,Big 12,6,19,1,7,0,1,1,6,0,0,1,1,2,3,1,0,3,1,3
Belmont1,1,Dylan Windler,JR,F,Belmont,OVC,33,1168,204,365,135,203,69,162,94,131,57,250,307,90,34,31,78,86,571
Belmont2,2,Amanze Egekeze,SR,F,Belmont,OVC,33,1139,184,364,88,138,96,226,89,111,39,166,205,31,19,8,42,61,553
Belmont3,3,Austin Luke,SR,G,Belmont,OVC,33,1084,103,237,31,63,72,174,25,31,7,88,95,246,32,2,104,53,303
Belmont4,4,Kevin McClain,JR,G,Belmont,OVC,33,1068,145,318,88,157,57,161,68,95,25,99,124,70,34,7,53,54,415
Belmont5,5,Mack Mercer,JR,F,Belmont,OVC,30,462,75,138,65,101,10,37,35,48,28,60,88,21,12,14,35,86,195
Belmont6,6,Nick Hopkins,FR,G,Belmont,OVC,28,461,70,167,14,26,56,141,12,16,12,43,55,25,18,1,16,37,208
Belmont7,7,Tyler Hadden,SR,C,Belmont,OVC,33,344,52,98,43,61,9,37,26,35,20,41,61,11,4,9,24,52,139
Belmont8,8,Burton Sampson,SR,G,Belmont,OVC,31,303,12,35,9,17,3,18,19,23,9,18,27,17,2,3,16,31,46
Belmont9,9,Seth Adelsperger,SO,C,Belmont,OVC,30,290,33,55,33,55,0,0,11,22,15,37,52,5,1,7,15,45,77
Belmont10,10,Michael Benkert,SO,G,Belmont,OVC,31,196,9,41,6,9,3,32,3,4,2,5,7,5,2,0,9,17,24
Belmont11,11,Grayson Murphy,,G,Belmont,OVC,4,50,9,20,9,14,0,6,0,1,0,6,6,7,2,0,4,5,18
Belmont12,12,Caleb Hollander,FR,F,Belmont,OVC,7,35,5,15,2,4,3,11,0,0,3,5,8,1,1,0,0,4,13
Bethune-Cookman1,1,Isaiah Bailey,JR,G,Bethune-Cookman,MEAC,31,998,150,353,122,251,28,102,172,219,42,123,165,149,27,8,123,91,500
Bethune-Cookman2,2,Brandon Tabb,SR,G,Bethune-Cookman,MEAC,30,938,172,433,75,145,97,288,126,138,23,86,109,49,46,11,68,84,567
Bethune-Cookman3,3,Soufiyane Diakite,JR,F,Bethune-Cookman,MEAC,32,891,134,234,126,210,8,24,59,94,102,211,313,36,27,29,63,86,335
Bethune-Cookman4,4,Shawntrez Davis,JR,F,Bethune-Cookman,MEAC,32,863,181,327,158,266,23,61,84,142,86,191,277,40,15,39,78,109,469
Bethune-Cookman5,5,Houston Smith,SO,G,Bethune-Cookman,MEAC,32,704,60,112,49,81,11,31,26,46,47,83,130,38,12,9,36,79,157
Bethune-Cookman6,6,Jeffrey Altidort,SR,G,Bethune-Cookman,MEAC,25,646,52,129,32,68,20,61,35,49,3,56,59,59,21,8,41,71,159
Bethune-Cookman7,7,Malik Maitland,JR,G,Bethune-Cookman,MEAC,22,644,76,219,48,136,28,83,41,59,17,43,60,99,34,3,42,48,221
Bethune-Cookman8,8,Armani Collins,JR,G,Bethune-Cookman,MEAC,26,359,36,119,12,22,24,97,10,13,13,45,58,14,10,9,13,38,106
Bethune-Cookman9,9,Davis Francis,JR,F,Bethune-Cookman,MEAC,26,225,29,61,27,56,2,5,11,28,29,27,56,14,7,5,13,33,71
Bethune-Cookman10,10,Ulmer Manzie,SO,F,Bethune-Cookman,MEAC,13,126,8,24,8,24,0,0,9,27,15,11,26,3,2,2,11,26,25
Bethune-Cookman11,11,Jamal Gaines,,G,Bethune-Cookman,MEAC,10,33,2,18,2,11,0,7,1,2,2,1,3,0,1,0,2,4,5
Bethune-Cookman12,12,Rodney Ross,SR,F,Bethune-Cookman,MEAC,7,23,3,10,3,10,0,0,0,2,5,0,5,0,0,0,1,1,6
Binghamton1,1,J.C. Show,JR,G,Binghamton,AEC,31,1005,146,390,70,164,76,226,61,70,22,93,115,60,39,2,56,64,429
Binghamton2,2,Thomas Bruce,JR,F,Binghamton,AEC,29,903,132,221,132,220,0,1,59,109,56,200,256,37,17,60,51,79,323
Binghamton3,3,Willie Rodriguez,SR,F,Binghamton,AEC,31,853,115,247,96,178,19,69,37,75,48,105,153,36,19,26,49,63,286
Binghamton4,4,Everson Davis,JR,G,Binghamton,AEC,31,736,76,165,60,131,16,34,65,88,29,84,113,67,26,3,39,58,233
Binghamton5,5,Timmy Rose,JR,G,Binghamton,AEC,31,677,52,121,37,82,15,39,23,42,8,44,52,87,14,3,55,39,142
Binghamton6,6,Fard Muhammad,SO,G,Binghamton,AEC,31,628,88,203,24,48,64,155,16,25,12,65,77,33,18,3,25,41,256
Binghamton7,7,Bobby Ahearn,SR,F,Binghamton,AEC,31,473,56,126,46,97,10,29,22,31,36,52,88,14,6,7,32,78,144
Binghamton8,8,Tyler Stewart,FR,F,Binghamton,AEC,24,349,51,120,38,81,13,39,21,32,14,37,51,14,12,9,25,40,136
Binghamton9,9,Caleb Stewart,JR,F,Binghamton,AEC,25,235,27,69,12,28,15,41,9,17,5,32,37,9,7,13,17,17,78
Binghamton10,10,Albert Odero,,G,Binghamton,AEC,15,144,17,50,15,36,2,14,15,24,14,5,19,9,5,3,10,18,51
Binghamton11,11,Dusan Perovic,SR,F,Binghamton,AEC,17,104,17,34,15,26,2,8,8,12,3,9,12,5,2,1,10,18,44
Binghamton12,12,John Schurman,JR,G,Binghamton,AEC,9,61,4,17,1,4,3,13,1,2,3,9,12,3,2,0,1,3,12
Binghamton13,13,Jordan McRae,JR,F,Binghamton,AEC,7,30,6,9,6,9,0,0,1,1,0,3,3,0,2,1,1,2,13
Binghamton14,14,Yosef Yacob,,G,Binghamton,AEC,4,27,0,3,0,0,0,3,0,0,0,3,3,2,1,0,1,2,0
Boise State1,1,Chandler Hutchison,SR,G,Boise State,MWC,30,921,194,415,151,293,43,122,149,205,23,201,224,105,42,8,96,71,580
Boise State2,2,Justinian Jessup,SO,G,Boise State,MWC,31,907,122,258,35,71,87,187,31,39,14,135,149,54,42,19,42,67,362
Boise State3,3,Christian Sengfelder,SR,F,Boise State,MWC,31,874,131,276,74,132,57,144,44,58,64,133,197,20,17,9,39,57,363
Boise State4,4,Lexus Williams,SR,G,Boise State,MWC,31,812,100,225,52,112,48,113,54,62,9,61,70,73,30,1,50,66,302
Boise State5,5,Alex Hobbs,SO,G,Boise State,MWC,31,793,112,225,96,172,16,53,34,39,11,70,81,76,11,1,71,45,274
Boise State6,6,Zach Haney,JR,F,Boise State,MWC,31,710,92,178,88,156,4,22,24,49,75,101,176,22,14,20,37,89,212
Boise State7,7,Marcus Dickinson,SO,G,Boise State,MWC,31,652,50,137,18,47,32,90,46,57,2,70,72,44,11,0,30,55,178
Boise State8,8,Robin Jorch,JR,C,Boise State,MWC,27,220,18,29,18,29,0,0,6,12,22,21,43,3,3,4,18,51,42
Boise State9,9,David Wacker,JR,F,Boise State,MWC,25,164,11,19,11,19,0,0,13,18,18,20,38,1,0,4,8,18,35
Boise State10,10,Cam Christon,FR,G,Boise State,MWC,14,83,9,23,3,7,6,16,4,7,5,12,17,8,1,1,7,8,28
Boise State11,11,Casdon Jardine,SO,G,Boise State,MWC,18,78,9,26,6,9,3,17,7,8,14,8,22,2,0,0,3,12,28
Boise State12,12,Malek Harwell,SO,G,Boise State,MWC,16,60,4,20,2,7,2,13,7,11,0,7,7,5,1,1,4,13,17
Boise State13,13,Derrick Alston,FR,G,Boise State,MWC,11,26,3,7,2,5,1,2,0,2,1,5,6,2,1,0,3,0,7
Boston College1,1,Ky Bowman,SO,G,Boston College,ACC,34,1299,213,501,134,286,79,215,91,114,29,203,232,163,51,12,107,87,596
Boston College2,2,Jerome Robinson,JR,G,Boston College,ACC,34,1220,242,495,162,304,80,191,146,176,18,107,125,116,30,5,94,83,710
Boston College3,3,Jordan Chatman,JR,G,Boston College,ACC,33,1210,138,330,51,112,87,218,69,77,16,82,98,53,21,1,27,56,432
Boston College4,4,Steffon Mitchell,FR,F,Boston College,ACC,33,1090,70,168,50,91,20,77,49,94,94,177,271,71,36,34,35,61,209
Boston College5,5,Nik Popovic,SO,F,Boston College,ACC,34,880,133,263,128,239,5,24,66,92,87,124,211,42,15,26,66,87,337
Boston College6,6,Johncarlos Reyes,SO,F,Boston College,ACC,33,348,41,74,41,74,0,0,10,21,28,46,74,6,2,11,25,61,92
Boston College7,7,Lucas Kraljevic,FR,F,Boston College,ACC,30,286,15,42,12,29,3,13,12,24,11,35,46,16,7,14,24,61,45
Boston College8,8,Deontae Hawkins,SR,F,Boston College,ACC,8,225,39,84,31,61,8,23,13,16,21,52,73,8,2,2,18,21,99
Boston College9,9,Vin Baker Jr.,FR,F,Boston College,ACC,28,206,19,56,11,16,8,40,8,10,9,17,26,5,3,2,18,22,54
Boston College10,10,Avery Wilson,FR,G,Boston College,ACC,14,46,8,14,6,11,2,3,3,8,1,2,3,1,3,1,9,3,21
Boston College11,11,Ervins Meznieks,JR,F,Boston College,ACC,10,46,3,9,1,2,2,7,3,3,1,8,9,3,1,0,3,9,11
Boston College12,12,Gordon Gehan,JR,G,Boston College,ACC,5,10,2,3,2,2,0,1,1,2,0,1,1,0,0,0,0,0,5
Boston College13,13,Sam Holtz,,F,Boston College,ACC,2,3,0,0,0,0,0,0,0,0,0,0,0,0,0,0,1,0,0
Boston College14,14,Mac Bohuny,,G,Boston College,ACC,2,2,0,0,0,0,0,0,0,0,0,0,0,1,0,0,0,0,0
Boston College15,15,Matt DiLuccio,SO,G,Boston College,ACC,2,2,0,0,0,0,0,0,0,0,0,0,0,0,0,0,0,0,0
Boston College16,16,Will Jackowitz,,F,Boston College,ACC,2,2,0,0,0,0,0,0,0,0,0,0,0,0,0,0,0,0,0
Boston University1,1,Tyler Scanlon,SO,F,Boston University,Patriot,31,968,111,249,64,129,47,120,55,71,31,141,172,94,44,4,60,54,324
Boston University2,2,Javante McCoy,FR,G,Boston University,Patriot,31,793,100,225,60,133,40,92,35,54,12,68,80,52,29,5,56,55,275
Boston University3,3,Will Goff,SR,G,Boston University,Patriot,30,762,55,138,10,21,45,117,16,29,9,35,44,30,22,8,26,46,171
Boston University4,4,Cedric Hankerson,SR,G,Boston University,Patriot,25,677,110,269,61,124,49,145,53,90,22,62,84,40,37,6,43,57,322
Boston University5,5,Walter Whyte,FR,G,Boston University,Patriot,27,664,88,183,71,137,17,46,58,86,39,96,135,30,23,14,46,46,251
Boston University6,6,Max Mahoney,SO,F,Boston University,Patriot,30,630,163,271,163,271,0,0,60,108,44,101,145,36,19,28,54,81,386
Boston University7,7,Eric Johnson,SR,G,Boston University,Patriot,29,501,20,67,7,26,13,41,29,38,4,44,48,59,16,2,24,31,82
Boston University8,8,Nick Havener,SR,F,Boston University,Patriot,27,406,78,145,77,142,1,3,24,38,39,63,102,26,21,24,44,78,181
Boston University9,9,Sukhmail Mathon,FR,C,Boston University,Patriot,31,355,36,79,36,79,0,0,9,18,31,60,91,24,4,10,33,45,81
Boston University10,10,Andrew Petcash,FR,G,Boston University,Patriot,25,219,19,45,10,21,9,24,7,10,7,13,20,11,9,1,14,15,54
Boston University11,11,Kamali Chambers,JR,G,Boston University,Patriot,20,162,11,35,8,22,3,13,7,13,1,8,9,14,4,1,7,16,32
Boston University12,12,Destin Barnes,SO,G,Boston University,Patriot,2,33,4,15,2,6,2,9,2,2,2,6,8,3,0,0,0,4,12
Boston University13,13,Cheddi Mosely,SR,G,Boston University,Patriot,2,31,5,9,2,5,3,4,2,2,0,6,6,1,1,0,2,3,15
Bowling Green State1,1,Justin Turner,FR,G,Bowling Green State,MAC,31,1051,169,416,119,284,50,132,104,128,26,87,113,81,47,9,74,56,492
Bowling Green State2,2,Dylan Frye,SO,G,Bowling Green State,MAC,31,918,124,329,65,162,59,167,58,80,12,86,98,73,23,6,49,65,365
Bowling Green State3,3,Demajeo Wiggins,JR,F,Bowling Green State,MAC,31,860,153,274,153,274,0,0,120,172,94,220,314,26,13,15,74,66,426
Bowling Green State4,4,Rodrick Caldwell,SO,G,Bowling Green State,MAC,31,770,77,212,41,102,36,110,76,103,6,49,55,82,20,1,44,47,266
Bowling Green State5,5,Derek Koch,FR,F,Bowling Green State,MAC,30,642,67,162,54,125,13,37,54,65,70,93,163,34,11,14,34,84,201
Bowling Green State6,6,Antwon Lillard,,G,Bowling Green State,MAC,23,553,67,156,46,91,21,65,61,78,17,83,100,45,26,9,41,77,216
Bowling Green State7,7,Matt Fox,SR,G,Bowling Green State,MAC,31,516,44,105,6,21,38,84,16,19,8,46,54,32,9,3,14,23,142
Bowling Green State8,8,Daeqwon Plowden,FR,G,Bowling Green State,MAC,32,484,62,147,49,98,13,49,17,33,33,61,94,13,14,13,27,56,154
Bowling Green State9,9,Nelly Cummings,FR,G,Bowling Green State,MAC,30,396,41,108,31,68,10,40,17,28,7,27,34,29,20,2,19,31,109
Bowling Green State10,10,Jeffrey Uju,JR,F,Bowling Green State,MAC,30,218,12,34,12,32,0,2,5,11,27,39,66,6,3,7,15,35,29
Bowling Green State11,11,Joniya Gadson,FR,C,Bowling Green State,MAC,16,83,8,13,8,13,0,0,4,11,9,16,25,2,2,4,11,26,20
Bowling Green State12,12,Ethan Good,,G,Bowling Green State,MAC,6,15,0,3,0,0,0,3,0,0,0,0,0,1,0,0,1,2,0
Bowling Green State13,13,De Andre' Austin,,G,Bowling Green State,MAC,6,14,3,4,2,3,1,1,2,2,0,6,6,1,1,0,0,1,9
Bradley1,1,Darrell Brown,SO,G,Bradley,MVC,33,1051,141,400,92,262,49,138,115,143,7,70,77,142,24,0,95,69,446
Bradley2,2,Dwayne Lautier-Ogunleye,JR,G,Bradley,MVC,33,865,77,174,58,110,19,64,78,112,45,109,154,88,17,2,44,81,251
Bradley3,3,Donte Thomas,SR,F,Bradley,MVC,33,857,150,276,143,244,7,32,78,110,80,159,239,32,36,34,52,90,385
Bradley4,4,Nate Kennell,SO,G,Bradley,MVC,33,849,99,262,30,82,69,180,37,48,12,78,90,61,22,5,49,81,304
Bradley5,5,Jayden Hodgson,SO,G,Bradley,MVC,32,750,45,106,20,43,25,63,26,36,5,48,53,45,28,0,37,60,141
Bradley6,6,Elijah Childs,FR,F,Bradley,MVC,33,691,113,225,106,199,7,26,44,82,77,127,204,21,24,46,45,76,277
Bradley7,7,Koch Bar,SO,C,Bradley,MVC,30,532,47,107,47,107,0,0,45,65,39,67,106,13,9,24,39,68,139
Bradley8,8,Luuk van Bree,JR,F,Bradley,MVC,26,330,47,103,26,53,21,50,10,15,14,49,63,7,11,10,16,39,125
Bradley9,9,Ryan Stipanovich,FR,G,Bradley,MVC,27,271,19,39,5,12,14,27,13,13,15,25,40,17,17,2,22,26,65
Bradley10,10,JoJo McGlaston,SR,G,Bradley,MVC,9,185,19,53,15,31,4,22,16,25,10,25,35,10,11,3,17,11,58
Bradley11,11,Luqman Lundy,JR,G,Bradley,MVC,25,138,6,27,4,15,2,12,6,10,3,12,15,11,11,2,10,14,20
Bradley12,12,Callum Barker,JR,C,Bradley,MVC,14,69,5,12,5,12,0,0,2,6,6,4,10,0,3,2,4,10,12
Bradley13,13,Peter Hanley,JR,F,Bradley,MVC,5,12,0,4,0,4,0,0,0,0,0,2,2,0,1,0,1,1,0
Brigham Young1,1,Elijah Bryant,JR,G,Brigham Young,WCC,34,1178,191,389,109,190,82,199,144,165,15,197,212,79,44,19,76,80,608
Brigham Young2,2,Yoeli Childs,SO,F,Brigham Young,WCC,34,1158,241,440,227,396,14,44,117,182,68,223,291,75,30,63,76,74,613
Brigham Young3,3,TJ Haws,SO,G,Brigham Young,WCC,34,1152,134,326,84,171,50,155,82,98,11,83,94,143,41,9,64,66,400
Brigham Young4,4,Jashire Hardnett,SO,G,Brigham Young,WCC,34,910,69,156,54,110,15,46,46,57,10,82,92,68,23,2,57,88,199
Brigham Young5,5,Zac Seljaas,SO,G,Brigham Young,WCC,34,678,65,140,42,65,23,75,23,28,15,48,63,48,13,9,27,59,176
Brigham Young6,6,McKay Cannon,JR,G,Brigham Young,WCC,28,536,33,79,18,33,15,46,20,25,4,29,33,42,27,1,21,41,101
Brigham Young7,7,Luke Worthington,JR,F,Brigham Young,WCC,34,498,56,115,56,115,0,0,34,57,33,61,94,16,12,7,19,73,146
Brigham Young8,8,Dalton Nixon,SO,F,Brigham Young,WCC,23,400,49,93,44,72,5,21,36,50,27,42,69,30,14,5,19,42,139
Brigham Young9,9,Payton Dastrup,SO,F,Brigham Young,WCC,30,229,35,67,23,41,12,26,16,24,10,47,57,14,9,13,19,29,98
Brigham Young10,10,Rylan Bergersen,FR,G,Brigham Young,WCC,23,78,9,16,6,9,3,7,3,4,0,9,9,2,2,0,3,11,24
Brigham Young11,11,Kajon Brown,JR,G,Brigham Young,WCC,9,39,2,4,2,3,0,1,3,5,1,0,1,1,2,0,4,8,7
Brigham Young12,12,Evan Troy,SO,G,Brigham Young,WCC,12,18,1,4,1,2,0,2,4,6,0,2,2,2,1,0,0,0,6
Brigham Young13,13,Braiden Shaw,,F,Brigham Young,WCC,1,1,0,0,0,0,0,0,0,0,0,0,0,0,0,0,0,1,0
Brown1,1,Brandon Anderson,SO,G,Brown,Ivy,27,912,133,352,100,238,33,114,169,196,18,54,72,106,40,3,81,61,468
Brown2,2,Zach Hunsaker,SO,G,Brown,Ivy,27,836,87,229,41,97,46,132,42,45,10,80,90,45,28,3,53,78,262
Brown3,3,Desmond Cambridge,FR,G,Brown,Ivy,27,809,160,399,92,196,68,203,80,104,25,97,122,33,29,27,39,77,468
Brown4,4,Tamenang Choh,FR,F,Brown,Ivy,27,627,72,135,71,129,1,6,49,77,55,92,147,40,13,19,43,94,194
Brown5,5,Obi Okolie,JR,G,Brown,Ivy,24,600,67,158,56,115,11,43,65,95,22,71,93,36,11,4,29,36,210
Brown6,6,Joshua Howard,SO,F,Brown,Ivy,27,481,59,120,46,82,13,38,29,41,34,53,87,25,20,13,29,60,160
Brown7,7,Matt DeWolf,FR,F,Brown,Ivy,27,392,29,52,29,52,0,0,24,47,39,80,119,13,12,5,29,41,82
Brown8,8,Jason Massey,SR,G,Brown,Ivy,27,348,41,69,40,66,1,3,15,23,16,55,71,15,7,2,23,45,98
Brown9,9,Chris Sullivan,JR,G,Brown,Ivy,27,279,19,52,7,14,12,38,11,11,12,17,29,5,11,1,6,31,61
Brown10,10,Travis Fuller,JR,F,Brown,Ivy,18,179,22,53,22,47,0,6,16,21,19,39,58,19,3,3,16,31,60
Brown11,11,David Erebor,SO,F,Brown,Ivy,6,22,5,7,5,7,0,0,2,3,7,3,10,0,0,1,2,8,12
Brown12,12,George Mawanda-Kalema,FR,G,Brown,Ivy,1,8,1,3,0,0,1,3,0,2,0,0,0,0,0,0,0,2,3
Brown13,13,Jake Shaper,FR,G,Brown,Ivy,2,4,0,1,0,0,0,1,0,0,0,0,0,0,0,0,0,0,0
Brown14,14,Patrick Triplett,SR,G,Brown,Ivy,1,4,0,1,0,0,0,1,2,2,0,1,1,1,0,0,1,1,2
Bryant1,1,Ikenna Ndugba,SO,G,Bryant,NEC,31,1104,140,366,89,214,51,152,96,129,16,113,129,144,61,1,99,94,427
Bryant2,2,Adam Grant,SO,G,Bryant,NEC,27,997,148,393,83,203,65,190,59,84,23,65,88,68,28,1,67,59,420
Bryant3,3,Bosko Kostur,SR,G,Bryant,NEC,29,729,102,212,54,106,48,106,48,58,29,80,109,21,17,5,49,94,300
Bryant4,4,Hunter Ware,SR,G,Bryant,NEC,31,698,64,143,58,127,6,16,20,28,22,81,103,45,30,6,36,75,154
Bryant5,5,Brandon Carroll,FR,F,Bryant,NEC,29,498,67,150,60,119,7,31,42,63,38,81,119,15,18,10,32,68,183
Bryant6,6,Sebastian Townes,SO,F,Bryant,NEC,22,493,93,211,93,202,0,9,62,90,42,45,87,39,8,5,35,49,248
Bryant7,7,Ryan Layman,FR,F,Bryant,NEC,30,429,32,77,20,36,12,41,5,10,20,55,75,10,8,5,19,33,81
Bryant8,8,Tanner Johnson,SO,G,Bryant,NEC,24,384,49,139,5,12,44,127,5,7,8,33,41,15,2,0,12,26,147
Bryant9,9,Taylor McHugh,JR,G,Bryant,NEC,17,331,22,64,10,25,12,39,9,12,5,19,24,33,9,1,18,25,65
Bryant10,10,Mantvydas Urmilevicius,FR,F,Bryant,NEC,19,244,29,56,29,56,0,0,12,25,30,35,65,14,5,1,11,27,70
Bryant11,11,Angus Riley,SR,F,Bryant,NEC,24,239,20,57,7,17,13,40,8,12,15,33,48,12,3,2,8,35,61
Bryant12,12,Aram Martin,SR,F,Bryant,NEC,6,79,5,12,4,9,1,3,2,4,2,6,8,1,1,6,6,15,13
Bucknell1,1,Zach Thomas,SR,F,Bucknell,Patriot,34,1084,199,432,139,271,60,161,231,300,45,267,312,74,34,24,103,66,689
Bucknell2,2,Stephen Brown,SR,G,Bucknell,Patriot,34,1024,181,374,121,211,60,163,85,101,17,97,114,147,41,8,59,80,507
Bucknell3,3,Nana Foulland,SR,C,Bucknell,Patriot,34,969,207,345,207,343,0,2,111,197,73,167,240,45,18,61,60,88,525
Bucknell4,4,Jimmy Sotos,FR,G,Bucknell,Patriot,34,758,45,117,22,57,23,60,49,63,8,84,92,68,27,3,48,63,162
Bucknell5,5,Bruce Moore,SO,F,Bucknell,Patriot,30,651,52,122,30,55,22,67,41,55,29,38,67,12,9,25,26,77,167
Bucknell6,6,Kimbal MacKenzie,JR,G,Bucknell,Patriot,23,609,59,167,20,53,39,114,24,24,15,27,42,51,13,2,32,43,181
Bucknell7,7,Nate Sestina,JR,F,Bucknell,Patriot,33,490,86,155,73,116,13,39,29,39,36,91,127,30,11,20,35,68,214
Bucknell8,8,Nate Jones,JR,G,Bucknell,Patriot,31,350,22,68,6,12,16,56,9,17,11,33,44,20,8,1,7,29,69
Bucknell9,9,Avi Toomer,SO,G,Bucknell,Patriot,17,346,28,69,10,24,18,45,10,12,13,28,41,18,12,2,12,55,84
Bucknell10,10,Ben Robertson,SO,G,Bucknell,Patriot,29,206,20,39,17,25,3,14,6,16,12,27,39,10,3,2,11,23,49
Bucknell11,11,John Meeks,FR,F,Bucknell,Patriot,28,169,24,46,22,31,2,15,3,6,10,16,26,9,2,0,10,14,53
Bucknell12,12,Matt O'Reilly,,G,Bucknell,Patriot,19,137,13,40,1,1,12,39,2,2,3,1,4,3,7,1,9,13,40
Bucknell13,13,Paul Newman,FR,C,Bucknell,Patriot,19,73,4,9,4,9,0,0,6,13,3,15,18,2,4,2,7,8,14
Bucknell14,14,Jordan Sechan,FR,G,Bucknell,Patriot,14,34,2,12,1,3,1,9,0,0,0,4,4,3,2,0,3,5,5
Buffalo1,1,C.J. Massinburg,JR,G,Buffalo,MAC,34,1152,186,397,105,191,81,206,121,164,74,176,250,85,39,16,56,71,574
Buffalo2,2,Jeremy Harris,JR,G,Buffalo,MAC,34,1126,189,399,100,193,89,206,57,71,46,156,202,76,35,26,42,74,524
Buffalo3,3,Nick Perkins,JR,F,Buffalo,MAC,34,936,204,426,171,323,33,103,122,165,77,133,210,27,11,23,68,81,563
Buffalo4,4,Davonta Jordan,SO,G,Buffalo,MAC,34,866,98,208,79,145,19,63,18,37,13,87,100,142,40,13,79,101,233
Buffalo5,5,Wes Clark,,G,Buffalo,MAC,24,708,126,271,83,161,43,110,56,75,8,77,85,127,31,4,54,71,351
Buffalo6,6,Jayvon Graves,FR,G,Buffalo,MAC,34,568,64,166,37,86,27,80,27,45,25,53,78,36,17,29,27,53,182
Buffalo7,7,Montell McRae,JR,F,Buffalo,MAC,34,455,42,90,30,46,12,44,11,24,35,52,87,12,9,12,22,75,107
Buffalo8,8,Dontay Caruthers,JR,G,Buffalo,MAC,23,415,64,105,50,76,14,29,18,32,18,36,54,48,18,1,34,69,160
Buffalo9,9,Ikenna Smart,,F,Buffalo,MAC,25,311,38,57,38,56,0,1,14,29,33,55,88,3,5,11,20,61,90
Buffalo10,10,James Reese,FR,G,Buffalo,MAC,23,193,19,60,11,19,8,41,15,16,6,16,22,17,8,4,11,32,61
Buffalo11,11,Brock Bertram,FR,C,Buffalo,MAC,15,83,9,17,9,17,0,0,2,4,12,7,19,1,3,4,4,19,20
Buffalo12,12,Dominic Johnson,,F,Buffalo,MAC,9,25,4,5,3,3,1,2,0,0,0,6,6,0,1,0,2,3,9
Buffalo13,13,Colby Moultrie,FR,G,Buffalo,MAC,10,20,1,2,0,1,1,1,0,0,1,2,3,1,0,0,5,6,3
Buffalo14,14,Gabe Agorioge,SR,F,Buffalo,MAC,11,17,1,2,0,1,1,1,3,4,1,0,1,1,0,0,1,3,6
Butler1,1,Kelan Martin,SR,F,Butler,Big East,33,1172,241,546,154,306,87,240,118,142,31,174,205,67,25,16,76,64,687
Butler2,2,Kamar Baldwin,SO,G,Butler,Big East,33,1115,196,442,150,301,46,141,72,95,12,147,159,103,51,14,73,83,510
Butler3,3,Paul Jorgensen,JR,G,Butler,Big East,33,928,124,295,66,131,58,164,40,47,16,91,107,86,37,2,32,49,346
Butler4,4,Aaron Thompson,FR,G,Butler,Big East,33,787,50,129,48,115,2,14,40,74,6,40,46,107,36,13,52,98,142
Butler5,5,Sean McDermott,SO,G,Butler,Big East,29,682,75,152,32,49,43,103,18,22,34,76,110,32,21,7,27,61,211
Butler6,6,Tyler Wideman,SR,F,Butler,Big East,32,647,115,168,115,166,0,2,71,86,70,93,163,14,15,14,42,89,301
Butler7,7,Nate Fowler,JR,C,Butler,Big East,33,581,89,146,81,122,8,24,16,19,43,58,101,19,16,16,22,77,202
Butler8,8,Henry Baddley,SO,G,Butler,Big East,33,509,49,93,29,51,20,42,22,26,12,53,65,19,16,12,18,45,140
Butler9,9,Christian David,FR,G,Butler,Big East,24,137,10,28,7,13,3,15,5,9,5,10,15,9,4,1,8,19,28
Butler10,10,Joey Brunk,SO,F,Butler,Big East,20,109,11,21,11,21,0,0,3,6,13,22,35,3,0,2,7,10,25
Butler11,11,Jerald Gillens-Butler,FR,G,Butler,Big East,12,61,3,16,1,7,2,9,6,8,3,3,6,2,0,0,4,7,14
Butler12,12,Campbell Donovan,FR,G,Butler,Big East,10,22,1,5,0,0,1,5,2,2,0,0,0,1,1,0,0,0,5
Cal Poly1,1,Donovan Fields,JR,PG,Cal Poly,Big West,31,999,145,355,108,264,37,91,75,81,9,93,102,126,36,4,73,77,402
Cal Poly2,2,Victor Joseph,SR,G,Cal Poly,Big West,31,913,147,363,83,186,64,177,88,100,18,61,79,59,26,5,59,64,446
Cal Poly3,3,Luke Meikle,SR,F,Cal Poly,Big West,31,789,94,253,61,154,33,99,48,56,29,103,132,36,14,8,36,62,269
Cal Poly4,4,Hank Hollingsworth,SO,F,Cal Poly,Big West,31,591,41,65,41,65,0,0,13,37,37,67,104,7,7,52,28,67,95
Cal Poly5,5,Mark Crowe,FR,F,Cal Poly,Big West,31,549,26,84,13,32,13,52,7,13,22,56,78,27,18,8,17,62,72
Cal Poly6,6,Jakub Niziol,JR,F,Cal Poly,Big West,30,548,66,182,17,40,49,142,35,43,11,57,68,23,14,11,16,39,216
Cal Poly7,7,Josh Martin,JR,F,Cal Poly,Big West,25,498,65,177,49,129,16,48,38,58,23,103,126,32,9,14,51,46,184
Cal Poly8,8,Marcellus Garrick,JR,G,Cal Poly,Big West,27,451,61,148,33,75,28,73,25,33,16,27,43,12,8,2,15,33,175
Cal Poly9,9,Aleks Abrams,JR,F,Cal Poly,Big West,24,321,21,47,21,47,0,0,16,22,41,61,102,10,4,14,15,37,58
Cal Poly10,10,Iziah James,FR,PG,Cal Poly,Big West,26,247,18,54,10,32,8,22,14,16,3,17,20,17,9,1,21,31,58
Cal Poly11,11,Karlis Garoza,FR,F,Cal Poly,Big West,21,237,16,40,16,39,0,1,8,13,26,30,56,12,5,3,17,34,40
Cal Poly12,12,Trevor John,JR,G,Cal Poly,Big West,23,206,21,49,2,7,19,42,6,6,4,10,14,11,4,0,4,12,67
Cal Poly13,13,Paulo Cruz,,F,Cal Poly,Big West,1,1,0,0,0,0,0,0,0,0,0,0,0,0,0,0,0,0,0
Cal State Bakersfield1,1,Rickey Holden,JR,G,Cal State Bakersfield,WAC,30,920,112,270,77,153,35,117,64,78,20,62,82,85,38,0,63,62,323
Cal State Bakersfield2,2,Jarkell Joiner,FR,G,Cal State Bakersfield,WAC,30,840,106,280,74,168,32,112,69,77,28,75,103,22,15,1,28,54,313
Cal State Bakersfield3,3,Brent Wrapp,SR,G,Cal State Bakersfield,WAC,29,805,25,87,17,53,8,34,44,61,26,106,132,148,36,3,58,84,102
Cal State Bakersfield4,4,Damiyne Durham,JR,G,Cal State Bakersfield,WAC,28,751,124,331,55,108,69,223,26,38,21,59,80,38,31,10,39,31,343
Cal State Bakersfield5,5,Justin Davis,FR,G,Cal State Bakersfield,WAC,30,652,80,176,56,108,24,68,47,55,51,114,165,25,26,2,34,73,231
Cal State Bakersfield6,6,Moataz Aly,SR,C,Cal State Bakersfield,WAC,30,596,101,148,101,148,0,0,34,88,39,58,97,6,4,53,66,103,236
Cal State Bakersfield7,7,Shon Briggs,SR,F,Cal State Bakersfield,WAC,23,579,78,213,74,194,4,19,78,110,40,86,126,43,17,7,46,55,238
Cal State Bakersfield8,8,Fallou Ndoye,SR,C,Cal State Bakersfield,WAC,29,375,31,62,31,62,0,0,19,39,36,56,92,3,1,7,39,76,81
Cal State Bakersfield9,9,Greg Lee,FR,F,Cal State Bakersfield,WAC,28,246,25,61,15,31,10,30,1,4,12,38,50,10,5,0,19,32,61
Cal State Bakersfield10,10,Justin McCall,FR,G,Cal State Bakersfield,WAC,23,195,10,28,9,25,1,3,10,18,18,16,34,5,8,4,8,14,31
Cal State Bakersfield11,11,Bray Barnes,JR,F,Cal State Bakersfield,WAC,13,35,5,11,3,5,2,6,10,11,3,5,8,2,0,0,1,11,22
Cal State Bakersfield12,12,James Suber,SR,F,Cal State Bakersfield,WAC,4,6,0,3,0,2,0,1,0,0,1,0,1,0,1,0,0,2,0
Cal State Fullerton1,1,Kyle Allman,JR,G,Cal State Fullerton,Big West,31,1018,190,389,147,289,43,100,179,239,10,96,106,73,36,6,70,67,602
Cal State Fullerton2,2,Khalil Ahmad,JR,G,Cal State Fullerton,Big West,31,968,166,395,110,221,56,174,87,105,17,100,117,52,39,7,75,64,475
Cal State Fullerton3,3,Jackson Rowe,SO,F,Cal State Fullerton,Big West,30,898,133,229,110,173,23,56,77,99,42,163,205,49,28,30,61,68,366
Cal State Fullerton4,4,Austen Awosika,SO,G,Cal State Fullerton,Big West,31,846,79,192,72,159,7,33,64,94,18,97,115,83,31,7,55,40,229
Cal State Fullerton5,5,Jamal Smith,SO,G,Cal State Fullerton,Big West,31,703,35,80,22,47,13,33,41,54,6,72,78,59,17,4,51,93,124
Cal State Fullerton6,6,Davon Clare,SO,F,Cal State Fullerton,Big West,31,540,39,92,32,65,7,27,19,27,31,75,106,35,15,11,36,44,104
Cal State Fullerton7,7,Arkim Robertson,SR,F,Cal State Fullerton,Big West,31,483,63,97,63,97,0,0,40,61,53,80,133,7,11,27,31,83,166
Cal State Fullerton8,8,Dominik Heinzl,JR,F,Cal State Fullerton,Big West,29,294,27,49,27,49,0,0,13,18,15,35,50,4,6,5,20,34,67
Cal State Fullerton9,9,Daniel Venzant,FR,G,Cal State Fullerton,Big West,23,136,17,33,14,22,3,11,4,11,0,14,14,12,3,0,9,14,41
Cal State Fullerton10,10,Dwight Ramos,SO,G,Cal State Fullerton,Big West,17,119,14,46,9,23,5,23,4,8,9,7,16,9,4,0,11,13,37
Cal State Fullerton11,11,Josh Pitts,FR,F,Cal State Fullerton,Big West,18,84,9,25,9,25,0,0,4,8,11,11,22,3,2,1,3,22,22
Cal State Fullerton12,12,Johnny Wang,FR,F,Cal State Fullerton,Big West,13,69,3,12,2,6,1,6,3,5,2,16,18,3,1,2,4,6,10
Cal State Fullerton13,13,Landon Kirkwood,FR,G,Cal State Fullerton,Big West,10,49,7,11,4,5,3,6,0,0,2,4,6,3,2,0,2,5,17
Cal State Fullerton14,14,Ian Fox,JR,G,Cal State Fullerton,Big West,5,38,2,14,0,3,2,11,0,0,4,0,4,4,2,1,1,0,6
Cal State Fullerton15,15,Jose Garcia Gonzalez,FR,G,Cal State Fullerton,Big West,1,4,2,7,2,5,0,2,0,0,4,1,5,0,1,0,0,0,4
Cal State Northridge1,1,Terell Gomez,FR,G,Cal State Northridge,Big West,30,1022,121,277,56,136,65,141,44,55,12,60,72,109,19,0,62,50,351
Cal State Northridge2,2,Tavrion Dawson,SR,F,Cal State Northridge,Big West,30,988,195,440,168,336,27,104,84,118,46,152,198,59,27,22,70,64,501
Cal State Northridge3,3,Lyrik Shreiner,SO,G,Cal State Northridge,Big West,30,875,99,219,83,163,16,56,57,74,35,106,141,60,24,8,73,67,271
Cal State Northridge4,4,Micheal Warren,SR,G,Cal State Northridge,Big West,27,846,108,245,69,142,39,103,72,85,18,147,165,52,33,11,52,92,327
Cal State Northridge5,5,Reggie Theus,SR,F,Cal State Northridge,Big West,30,694,81,197,76,187,5,10,19,39,33,33,66,18,12,8,31,75,186
Cal State Northridge6,6,Jonathan Guevara,,G,Cal State Northridge,Big West,25,391,19,61,13,41,6,20,13,25,1,27,28,28,7,1,21,34,57
Cal State Northridge7,7,Zeno Lake,JR,F,Cal State Northridge,Big West,16,323,23,44,23,44,0,0,15,30,28,44,72,4,6,6,9,35,61
Cal State Northridge8,8,Jalon Pipkins,FR,G,Cal State Northridge,Big West,23,272,23,59,15,41,8,18,17,19,4,18,22,10,8,2,17,16,71
Cal State Northridge9,9,Mahamadou Kaba-Camara,SO,C,Cal State Northridge,Big West,24,224,17,26,17,26,0,0,3,13,14,33,47,2,3,5,7,46,37
Cal State Northridge10,10,Anthony Swan,JR,F,Cal State Northridge,Big West,22,206,17,49,9,20,8,29,0,1,5,18,23,17,7,9,7,17,42
Cal State Northridge11,11,Carl Brown,JR,G,Cal State Northridge,Big West,17,184,23,58,11,27,12,31,8,10,7,16,23,4,3,0,7,29,66
Cal State Northridge12,12,Blair Orr,JR,C,Cal State Northridge,Big West,10,38,5,9,5,9,0,0,2,2,4,2,6,0,0,2,2,6,12
Cal State Northridge13,13,Alex Sokol,FR,G,Cal State Northridge,Big West,7,12,0,4,0,1,0,3,1,2,0,0,0,1,0,0,1,2,1
Campbell1,1,Marcus Burk,SO,G,Campbell,Big South,31,982,161,330,76,118,85,212,51,60,21,93,114,36,41,7,44,57,458
Campbell2,2,Cory Gensler,SO,G,Campbell,Big South,31,950,89,209,42,88,47,121,13,21,19,117,136,51,27,9,25,76,238
Campbell3,3,Chris Clemons,JR,G,Campbell,Big South,28,950,207,461,123,233,84,228,189,219,10,117,127,85,44,9,72,52,687
Campbell4,4,Shane Whitfield,SR,F,Campbell,Big South,31,934,79,158,79,156,0,2,75,115,18,111,129,80,16,4,60,75,233
Campbell5,5,Andrew Eudy,JR,C,Campbell,Big South,31,787,121,225,98,174,23,51,29,37,51,105,156,83,31,59,65,90,294
Campbell6,6,Mogga Lado,SR,C,Campbell,Big South,31,511,43,77,43,77,0,0,38,59,31,76,107,36,13,21,27,50,124
Campbell7,7,Jordan Whitfield,FR,G,Campbell,Big South,26,438,31,76,18,35,13,41,7,9,12,33,45,38,11,1,25,42,82
Campbell8,8,Damontez Oliver,SO,F,Campbell,Big South,27,332,37,79,14,23,23,56,19,29,7,38,45,12,7,1,16,48,116
Campbell9,9,Ja'cor Nelson,,G,Campbell,Big South,25,223,17,44,17,36,0,8,10,22,10,26,36,12,10,5,23,27,44
Campbell10,10,Brooks Cluxton,FR,F,Campbell,Big South,7,46,5,11,5,11,0,0,1,9,6,16,22,1,2,5,2,5,11
Campbell11,11,Nick Parker,SR,G,Campbell,Big South,7,40,6,16,2,5,4,11,2,2,1,10,11,6,0,0,3,3,18
Campbell12,12,Jon Ander Cuadra,JR,F,Campbell,Big South,5,34,12,14,9,11,3,3,4,7,1,4,5,1,1,2,2,5,31
Campbell13,13,Nick Greely,FR,F,Campbell,Big South,3,15,4,6,4,6,0,0,4,5,2,0,2,2,1,0,1,3,12
Campbell14,14,Wyatt Self,SO,G,Campbell,Big South,3,8,1,2,0,0,1,2,0,0,0,0,0,2,1,0,0,0,3
Canisius1,1,Isaiah Reese,SO,G,Canisius,MAAC,32,1059,192,416,113,194,79,222,70,80,18,168,186,151,71,3,86,67,533
Canisius2,2,Malik Johnson,SO,G,Canisius,MAAC,32,1051,85,195,52,98,33,97,43,58,4,102,106,149,45,4,54,74,246
Canisius3,3,Jermaine Crumpton,SR,F,Canisius,MAAC,32,1026,201,411,155,271,46,140,99,128,64,108,172,50,20,17,59,58,547
Canisius4,4,Takal Molson,FR,G,Canisius,MAAC,32,929,135,301,91,184,44,117,88,131,57,102,159,81,35,14,66,84,402
Canisius5,5,Jonathan Sanks,JR,G,Canisius,MAAC,30,482,55,136,18,47,37,89,18,26,8,37,45,30,6,1,18,54,165
Canisius6,6,Selvedin Planincic,SR,C,Canisius,MAAC,31,473,56,103,46,60,10,43,23,35,22,67,89,24,11,28,37,82,145
Canisius7,7,Spencer Foley,SO,G,Canisius,MAAC,27,364,55,111,21,33,34,78,9,13,24,20,44,22,8,1,13,21,153
Canisius8,8,Marcale Lotts,JR,F,Canisius,MAAC,31,302,26,41,26,41,0,0,6,17,31,28,59,6,5,1,23,62,58
Canisius9,9,Jalanni White,FR,F,Canisius,MAAC,24,237,22,47,21,36,1,11,9,16,22,18,40,8,7,12,15,42,54
Canisius10,10,Jibreel Faulkner,,F,Canisius,MAAC,16,234,36,77,26,48,10,29,11,21,13,23,36,14,7,2,12,13,93
Canisius11,11,Scott Hitchon,FR,F,Canisius,MAAC,20,132,11,24,9,15,2,9,10,15,4,19,23,3,1,9,10,32,34
Canisius12,12,D.J. Heath,FR,G,Canisius,MAAC,20,104,4,17,3,7,1,10,2,5,2,6,8,4,2,0,6,13,11
Canisius13,13,Shaquille Evans,,G,Canisius,MAAC,2,5,0,1,0,1,0,0,0,0,0,1,1,0,0,0,0,0,0
Canisius14,14,Dantai St. Louis,,F,Canisius,MAAC,3,2,0,0,0,0,0,0,0,0,0,0,0,0,0,1,0,0,0
Central Arkansas1,1,Jordan Howard,SR,G,Central Arkansas,Southland,33,1185,263,572,154,306,109,266,200,224,10,109,119,88,35,0,74,39,835
Central Arkansas2,2,Mathieu Kamba,SR,G,Central Arkansas,Southland,33,997,164,318,137,241,27,77,109,164,66,138,204,75,37,31,78,77,464
Central Arkansas3,3,Deandre Jones,FR,G,Central Arkansas,Southland,33,920,63,148,28,58,35,90,39,46,16,105,121,150,53,5,70,84,200
Central Arkansas4,4,Hayden Koval,FR,C,Central Arkansas,Southland,32,802,99,219,69,126,30,93,45,73,45,127,172,28,12,97,52,97,273
Central Arkansas5,5,Thatch Unruh,JR,G,Central Arkansas,Southland,33,795,101,237,54,93,47,144,57,73,19,101,120,84,29,3,57,75,306
Central Arkansas6,6,Matthew Mondesir,FR,G,Central Arkansas,Southland,33,445,43,104,35,81,8,23,26,46,19,33,52,28,14,2,20,37,120
Central Arkansas7,7,Ethan Lee,SR,F,Central Arkansas,Southland,28,437,48,93,48,93,0,0,23,41,42,60,102,25,15,8,27,58,119
Central Arkansas8,8,Tanner Schmit,JR,F,Central Arkansas,Southland,33,417,64,152,64,149,0,3,17,26,24,41,65,10,4,10,13,79,145
Central Arkansas9,9,Darraja Parnell,SO,G,Central Arkansas,Southland,30,294,37,87,30,69,7,18,22,33,18,42,60,30,15,1,33,43,103
Central Arkansas10,10,Aaron Weidenaar,SO,F,Central Arkansas,Southland,24,159,13,39,5,10,8,29,1,2,6,12,18,7,1,2,9,32,35
Central Arkansas11,11,Otas Iyekekpolor,JR,F,Central Arkansas,Southland,21,134,12,25,12,25,0,0,7,10,15,13,28,2,2,6,11,26,31
Central Arkansas12,12,Jared Chatham,FR,F,Central Arkansas,Southland,17,75,14,25,12,21,2,4,7,13,5,11,16,1,2,1,4,9,37
Central Arkansas13,13,Jordan Grant,SO,G,Central Arkansas,Southland,10,21,0,1,0,0,0,1,0,0,0,2,2,4,1,0,1,1,0
Central Arkansas14,14,Tyler Simmons,JR,G,Central Arkansas,Southland,8,15,0,5,0,0,0,5,0,0,0,1,1,0,0,0,0,1,0
Central Arkansas15,15,Brandon Vanover,,C,Central Arkansas,Southland,3,3,0,0,0,0,0,0,0,0,0,0,0,0,0,0,0,0,0
Central Connecticut State1,1,Austin Nehls,JR,G,Central Connecticut State,NEC,32,1101,100,260,33,65,67,195,43,67,29,96,125,40,19,5,27,35,310
Central Connecticut State2,2,Tyler Kohl,JR,G,Central Connecticut State,NEC,31,1080,180,427,137,279,43,148,115,146,59,195,254,128,42,4,114,61,518
Central Connecticut State3,3,Mustafa Jones,SR,F,Central Connecticut State,NEC,32,909,146,277,144,268,2,9,34,47,40,112,152,30,21,35,48,63,328
Central Connecticut State4,4,Deion Bute,JR,C,Central Connecticut State,NEC,32,802,123,205,123,205,0,0,78,109,75,91,166,19,14,35,83,117,324
Central Connecticut State5,5,Eric Bowles,JR,G,Central Connecticut State,NEC,29,746,42,93,35,70,7,23,28,52,20,41,61,82,25,1,46,66,119
Central Connecticut State6,6,Joe Hugley,SO,F,Central Connecticut State,NEC,30,568,92,204,48,92,44,112,56,73,31,86,117,11,10,15,49,84,284
Central Connecticut State7,7,Tyson Batiste,SO,G,Central Connecticut State,NEC,25,481,29,64,20,42,9,22,3,18,5,53,58,45,14,2,29,45,70
Central Connecticut State8,8,Shakaris Laney,JR,G,Central Connecticut State,NEC,22,356,23,64,15,35,8,29,7,11,7,24,31,24,9,3,23,30,61
Central Connecticut State9,9,Kashaun Hicks,FR,F,Central Connecticut State,NEC,20,221,28,76,13,36,15,40,17,24,7,21,28,6,3,4,24,17,88
Central Connecticut State10,10,Talek Williams,,G,Central Connecticut State,NEC,11,118,9,26,8,17,1,9,10,13,1,8,9,9,3,2,7,12,29
Central Connecticut State11,11,Chris Williams,,G,Central Connecticut State,NEC,14,75,9,27,7,15,2,12,3,3,3,6,9,1,1,0,5,3,23
Central Connecticut State12,12,Harrison Kay,SO,F,Central Connecticut State,NEC,12,54,6,14,6,12,0,2,3,5,5,8,13,1,0,0,4,14,15
Central Connecticut State13,13,Donyell Marshall Jr.,SO,F,Central Connecticut State,NEC,7,14,1,3,1,3,0,0,0,0,1,1,2,0,0,1,0,2,2
Central Florida1,1,A.J. Davis,SR,F,Central Florida,AAC,31,1023,119,273,89,182,30,91,112,162,60,175,235,67,29,12,65,65,380
Central Florida2,2,Terrell Allen,SO,G,Central Florida,AAC,32,960,63,156,53,126,10,30,39,57,21,75,96,88,43,0,55,77,175
Central Florida3,3,Dayon Griffin,JR,G,Central Florida,AAC,32,877,95,271,39,97,56,174,31,53,22,108,130,38,26,9,42,44,277
Central Florida4,4,Ceasar DeJesus,FR,G,Central Florida,AAC,32,877,94,226,77,181,17,45,69,93,14,59,73,58,24,0,61,50,274
Central Florida5,5,Chad Brown,JR,F,Central Florida,AAC,32,597,56,110,56,110,0,0,53,93,57,90,147,5,16,34,26,72,165
Central Florida6,6,B.J. Taylor,JR,G,Central Florida,AAC,16,495,80,201,54,134,26,67,68,101,3,29,32,51,8,0,28,20,254
Central Florida7,7,Tacko Fall,JR,C,Central Florida,AAC,16,351,79,103,79,103,0,0,23,50,40,77,117,5,5,31,42,41,181
Central Florida8,8,Djordjije Mumin,SR,G,Central Florida,AAC,29,338,27,75,1,8,26,67,3,4,5,17,22,5,2,0,9,22,83
Central Florida9,9,Chance McSpadden,SO,G,Central Florida,AAC,18,303,35,94,28,61,7,33,19,25,14,39,53,10,13,2,30,16,96
Central Florida10,10,Rokas Ulvydas,SO,F,Central Florida,AAC,26,277,22,46,22,46,0,0,17,30,17,43,60,1,2,22,16,45,61
Central Florida11,11,Myles Douglas,FR,F,Central Florida,AAC,31,276,20,68,15,39,5,29,16,34,4,29,33,9,1,1,25,29,61
Central Florida12,12,Nathan Laing,SR,G,Central Florida,AAC,20,51,0,4,0,2,0,2,0,0,0,5,5,2,0,0,4,7,0
Central Michigan1,1,David DiLeo,SO,F,Central Michigan,MAC,33,1112,120,319,38,77,82,242,61,77,64,161,225,48,31,8,25,59,383
Central Michigan2,2,Shawn Roundtree,JR,G,Central Michigan,MAC,33,1084,150,391,97,235,53,156,142,169,21,75,96,127,22,1,100,57,495
Central Michigan3,3,Cecil Williams,SR,F,Central Michigan,MAC,33,1001,172,363,151,292,21,71,143,187,48,165,213,85,35,37,96,100,508
Central Michigan4,4,Kevin McKay,SO,G,Central Michigan,MAC,31,840,139,253,129,222,10,31,82,96,92,111,203,54,56,20,62,76,370
Central Michigan5,5,Josh Kozinski,SR,G,Central Michigan,MAC,33,797,60,176,3,8,57,168,25,29,8,64,72,14,17,2,7,53,202
Central Michigan6,6,Luke Meyer,SR,F,Central Michigan,MAC,33,784,115,218,66,101,49,117,40,44,51,110,161,23,10,41,29,81,319
Central Michigan7,7,Gavin Peppers,JR,G,Central Michigan,MAC,30,415,55,138,37,79,18,59,33,41,9,26,35,38,15,1,24,28,161
Central Michigan8,8,Matt Beachler,FR,G,Central Michigan,MAC,31,292,24,70,8,14,16,56,8,14,3,27,30,13,12,3,8,23,72
Central Michigan9,9,Matty Smith,,G,Central Michigan,MAC,23,178,8,23,7,19,1,4,1,3,2,11,13,29,5,1,18,25,18
Central Michigan10,10,Corey Redman,SO,G,Central Michigan,MAC,31,110,5,17,2,5,3,12,0,0,4,9,13,2,5,0,3,17,13
Central Michigan11,11,Innocent Nwoko,FR,C,Central Michigan,MAC,24,72,8,11,8,11,0,0,1,4,7,9,16,1,4,2,3,12,17
Central Michigan12,12,John McCarty,SR,F,Central Michigan,MAC,8,16,3,6,2,3,1,3,0,0,2,3,5,0,1,0,1,2,7
Central Michigan13,13,Austin Ervin,SO,F,Central Michigan,MAC,8,10,1,4,1,1,0,3,1,2,3,1,4,1,1,0,0,2,3
Central Michigan14,14,Adam Kozinski,FR,G,Central Michigan,MAC,6,8,1,7,0,0,1,7,0,0,0,1,1,0,0,0,0,1,3
Central Michigan15,15,Jamarrio Rule,FR,F,Central Michigan,MAC,4,6,0,0,0,0,0,0,1,2,0,1,1,1,0,0,0,0,1
Charleston Southern1,1,Christian Keeling,SO,G,Charleston Southern,Big South,28,941,169,397,124,254,45,143,111,140,22,123,145,57,37,12,67,69,494
Charleston Southern2,2,Phlandrous Fleming Jr.,,G,Charleston Southern,Big South,29,812,106,254,63,136,43,118,52,72,39,75,114,47,36,12,42,50,307
Charleston Southern3,3,Travis McConico,JR,F,Charleston Southern,Big South,30,755,105,240,44,83,61,157,36,51,37,86,123,32,36,9,38,56,307
Charleston Southern4,4,Cortez Mitchell,SR,G,Charleston Southern,Big South,28,635,94,208,82,161,12,47,55,73,9,86,95,56,23,3,43,37,255
Charleston Southern5,5,Javis Howard,SR,F,Charleston Southern,Big South,31,626,71,139,68,128,3,11,24,33,54,74,128,15,12,6,32,36,169
Charleston Southern6,6,Ty Jones,FR,F,Charleston Southern,Big South,31,590,79,155,77,144,2,11,37,49,26,52,78,28,14,7,51,58,197
Charleston Southern7,7,Deontaye Buskey,FR,G,Charleston Southern,Big South,29,525,36,103,24,63,12,40,25,38,13,36,49,50,29,5,31,47,109
Charleston Southern8,8,Jordan Jones,SO,F,Charleston Southern,Big South,30,467,61,83,61,83,0,0,34,58,42,58,100,6,9,36,35,65,156
Charleston Southern9,9,Jamaal David,FR,G,Charleston Southern,Big South,21,313,24,59,14,30,10,29,20,29,17,37,54,26,7,7,31,25,78
Charleston Southern10,10,Sean Price,FR,F,Charleston Southern,Big South,21,226,22,50,13,23,9,27,9,12,8,13,21,22,11,2,7,22,62
Charleston Southern11,11,Jamar Martin,SR,F,Charleston Southern,Big South,25,196,14,45,11,23,3,22,7,10,14,28,42,17,6,4,9,19,38
Charleston Southern12,12,Jamal Thomas,SR,G,Charleston Southern,Big South,10,74,7,21,1,3,6,18,1,2,1,8,9,8,1,2,5,11,21
Charleston Southern13,13,JC Cavin,SR,G,Charleston Southern,Big South,9,58,6,14,4,7,2,7,3,5,0,0,0,4,2,0,3,11,17
Charleston Southern14,14,Abdul Sarki,JR,F,Charleston Southern,Big South,6,45,6,14,6,14,0,0,5,6,13,3,16,0,1,0,3,7,17
Charleston Southern15,15,Nathan Payne,FR,F,Charleston Southern,Big South,5,26,2,8,2,8,0,0,1,3,6,2,8,0,0,1,0,1,5
Charleston Southern16,16,Alex Stewart,FR,F,Charleston Southern,Big South,2,11,0,3,0,2,0,1,0,0,0,0,0,0,0,0,2,3,0
Charlotte1,1,Jon Davis,JR,G,Charlotte,CUSA,29,1051,159,406,111,260,48,146,143,181,25,85,110,160,27,9,114,44,509
Charlotte2,2,Austin Ajukwa,SR,G,Charlotte,CUSA,29,799,82,211,55,132,27,79,60,69,16,82,98,24,32,10,69,85,251
Charlotte3,3,Andrien White,JR,G,Charlotte,CUSA,25,682,118,276,75,143,43,133,96,120,26,95,121,31,42,6,47,73,375
Charlotte4,4,Najee Garvin,SO,F,Charlotte,CUSA,29,658,79,171,79,167,0,4,50,77,28,117,145,21,15,7,47,63,208
Charlotte5,5,Milos Supica,FR,F,Charlotte,CUSA,28,568,71,143,71,142,0,1,30,61,61,75,136,10,8,11,37,47,172
Charlotte6,6,Jailan Haslem,JR,C,Charlotte,CUSA,29,505,57,98,57,98,0,0,27,50,60,68,128,8,4,13,31,80,141
Charlotte7,7,Luka Vasic,FR,G,Charlotte,CUSA,24,405,28,73,12,33,16,40,18,32,8,55,63,21,9,0,25,41,90
Charlotte8,8,Ryan Murphy,FR,G,Charlotte,CUSA,19,379,46,113,14,33,32,80,4,8,1,21,22,18,10,0,18,28,128
Charlotte9,9,Jaylan McGill,FR,G,Charlotte,CUSA,28,360,24,71,3,12,21,59,5,5,1,13,14,14,7,0,12,25,74
Charlotte10,10,Hudson Price,SR,G,Charlotte,CUSA,9,258,32,51,21,30,11,21,17,22,6,37,43,9,9,1,14,24,92
Charlotte11,11,Bryant Thomas,FR,F,Charlotte,CUSA,10,127,8,16,8,16,0,0,6,12,5,20,25,2,2,8,5,12,22
Charlotte12,12,Bo Blight,FR,F,Charlotte,CUSA,7,14,1,3,1,3,0,0,0,0,1,4,5,0,0,0,0,0,2
Charlotte13,13,Corey Bias,SR,G,Charlotte,CUSA,6,14,1,2,1,2,0,0,0,0,0,2,2,1,0,0,0,2,2
Chattanooga1,1,Makale Foreman,SO,G,Chattanooga,Southern,33,1161,110,276,34,77,76,199,39,46,13,53,66,60,25,0,48,54,335
Chattanooga2,2,Nat Dixon,JR,G,Chattanooga,Southern,31,1130,140,320,74,153,66,167,83,113,37,106,143,59,31,8,63,54,429
Chattanooga3,3,Rodney Chatman,SO,G,Chattanooga,Southern,30,970,131,289,88,162,43,127,93,119,9,114,123,135,35,14,89,88,398
Chattanooga4,4,David Jean-Baptiste,FR,G,Chattanooga,Southern,33,891,75,198,40,84,35,114,22,31,23,47,70,63,26,3,39,48,207
Chattanooga5,5,Makinde London,JR,F,Chattanooga,Southern,29,769,133,333,88,199,45,134,84,115,40,158,198,52,26,23,86,83,395
Chattanooga6,6,James Lewis Jr.,FR,F,Chattanooga,Southern,27,700,67,132,67,132,0,0,63,95,59,85,144,19,8,6,57,67,197
Chattanooga7,7,Joshua Phillips,SR,F,Chattanooga,Southern,25,612,93,170,93,169,0,1,44,78,55,99,154,12,7,10,40,64,230
Chattanooga8,8,Jonathan Bryant II,FR,G,Chattanooga,Southern,24,215,18,47,17,37,1,10,9,16,12,20,32,5,4,0,12,16,46
Chattanooga9,9,Duane Moss,FR,F,Chattanooga,Southern,7,135,11,23,3,9,8,14,4,7,4,16,20,9,3,1,7,19,34
Chattanooga10,10,A.J. Bowers,,F,Chattanooga,Southern,14,74,3,4,3,3,0,1,2,2,5,9,14,2,1,2,4,11,8
Chattanooga11,11,Dylan Brewster,JR,G,Chattanooga,Southern,6,57,3,10,1,1,2,9,2,4,0,5,5,5,0,0,5,3,10
Chattanooga12,12,C.J. Massengill,FR,G,Chattanooga,Southern,2,7,0,1,0,1,0,0,0,0,0,0,0,0,0,0,0,0,0
Chattanooga13,13,Nick Desmarais,FR,F,Chattanooga,Southern,2,4,0,1,0,0,0,1,0,0,0,1,1,0,0,0,0,0,0
Chicago State1,1,Glen Burns,SR,G,Chicago State,WAC,32,1000,105,223,94,188,11,35,117,154,32,101,133,110,41,3,95,95,338
Chicago State2,2,Fred Sims Jr.,JR,G,Chicago State,WAC,30,922,146,453,85,262,61,191,73,84,24,88,112,34,23,2,44,43,426
Chicago State3,3,Deionte Simmons,SR,F,Chicago State,WAC,26,595,116,194,116,194,0,0,79,114,63,89,152,5,21,11,44,77,311
Chicago State4,4,Montana Byrd,SR,G,Chicago State,WAC,32,572,59,147,21,53,38,94,12,18,4,58,62,17,13,7,26,78,168
Chicago State5,5,Cameron Bowles,FR,F,Chicago State,WAC,29,570,48,119,45,101,3,18,36,44,22,56,78,18,19,26,36,81,135
Chicago State6,6,Anthony Harris,JR,G,Chicago State,WAC,28,556,56,126,44,89,12,37,37,52,21,51,72,34,26,14,35,73,161
Chicago State7,7,Rob Shaw,JR,G,Chicago State,WAC,30,530,57,162,57,148,0,14,17,23,14,33,47,74,28,0,51,33,131
Chicago State8,8,Jelani Pruitt,SR,G,Chicago State,WAC,30,470,78,182,71,158,7,24,34,64,43,73,116,24,16,3,49,51,197
Chicago State9,9,Travon Bell,FR,G,Chicago State,WAC,25,345,47,134,20,40,27,94,3,4,10,38,48,18,20,2,22,34,124
Chicago State10,10,Patrick Szpir,SO,F,Chicago State,WAC,26,326,22,50,22,47,0,3,23,29,11,36,47,6,5,6,30,48,67
Chicago State11,11,Alex Dubovitskiy,SR,G,Chicago State,WAC,24,196,12,31,6,10,6,21,5,7,3,17,20,4,5,1,11,36,35
Chicago State12,12,Jalen Stephens-Holmes,FR,F,Chicago State,WAC,8,84,9,19,9,18,0,1,2,5,12,12,24,3,2,5,6,16,20
Chicago State13,13,Nathan Townsen Jr.,,G,Chicago State,WAC,12,76,5,15,4,12,1,3,8,10,1,3,4,10,4,0,12,9,19
Chicago State14,14,Simeon Henton,FR,G,Chicago State,WAC,11,72,7,14,7,13,0,1,8,13,0,1,1,8,6,0,3,10,22
Chicago State15,15,John Joyce,JR,F,Chicago State,WAC,5,44,5,17,2,4,3,13,0,0,2,2,4,1,2,0,2,5,13
Chicago State16,16,Ken Odiase,,F,Chicago State,WAC,13,43,2,10,2,10,0,0,0,6,4,5,9,1,1,1,4,8,4
Cincinnati1,1,Jacob Evans,JR,G,Cincinnati,AAC,33,1006,145,332,87,180,58,152,79,102,43,106,149,107,44,34,58,65,427
Cincinnati2,2,Jarron Cumberland,SO,G,Cincinnati,AAC,33,942,122,298,69,142,53,156,65,101,34,92,126,97,34,13,59,66,362
Cincinnati3,3,Gary Clark,SR,F,Cincinnati,AAC,33,924,146,283,122,228,24,55,106,143,98,180,278,69,49,41,33,68,422
Cincinnati4,4,Kyle Washington,SR,F,Cincinnati,AAC,33,758,150,295,133,246,17,49,57,77,53,124,177,11,9,45,43,63,374
Cincinnati5,5,Justin Jenifer,JR,G,Cincinnati,AAC,33,640,47,127,19,50,28,77,41,51,7,27,34,82,15,0,22,43,163
Cincinnati6,6,Cane Broome,JR,G,Cincinnati,AAC,31,639,92,193,60,114,32,79,43,62,16,32,48,93,29,2,45,43,259
Cincinnati7,7,Tre Scott,SO,F,Cincinnati,AAC,33,406,38,69,38,68,0,1,28,47,47,72,119,32,15,6,22,33,104
Cincinnati8,8,Trevor Moore,FR,G,Cincinnati,AAC,32,385,34,97,9,21,25,76,23,34,14,43,57,13,18,2,14,34,116
Cincinnati9,9,Nysier Brooks,SO,C,Cincinnati,AAC,33,328,38,76,38,76,0,0,16,29,31,48,79,7,12,19,22,54,92
Cincinnati10,10,Keith Williams,FR,G,Cincinnati,AAC,31,325,40,103,36,76,4,27,17,32,15,25,40,14,15,5,27,22,101
Cincinnati11,11,Eliel Nsoseme,FR,F,Cincinnati,AAC,28,159,11,21,11,21,0,0,4,20,19,28,47,5,3,11,11,23,26
Cincinnati12,12,Mamoudou Diarra,FR,F,Cincinnati,AAC,7,46,7,20,6,18,1,2,5,6,5,8,13,2,1,5,4,3,20
Cincinnati13,13,Sam Martin,FR,G,Cincinnati,AAC,10,18,0,5,0,3,0,2,2,2,0,1,1,2,0,0,2,5,2
Cincinnati14,14,Jackson Bart,SO,F,Cincinnati,AAC,12,15,2,6,0,1,2,5,0,0,1,1,2,0,0,0,0,0,6
Cincinnati15,15,John Koz,SO,G,Cincinnati,AAC,8,9,1,1,1,1,0,0,0,0,1,1,2,1,0,0,1,0,2
Citadel1,1,Matt Frierson,JR,G,Citadel,Southern,32,904,125,344,11,30,114,314,67,75,13,69,82,43,35,1,41,32,431
Citadel2,2,Frankie Johnson,SO,G,Citadel,Southern,32,864,67,171,44,99,23,72,45,66,31,73,104,138,57,3,73,74,202
Citadel3,3,Zane Najdawi,JR,F,Citadel,Southern,31,781,172,335,128,227,44,108,91,128,37,118,155,30,21,42,79,69,479
Citadel4,4,Kaelon Harris,SO,G,Citadel,Southern,29,661,87,211,57,122,30,89,83,118,52,100,152,53,29,13,50,68,287
Citadel5,5,Leandro Allende,SO,G,Citadel,Southern,32,568,48,99,37,67,11,32,17,26,26,68,94,49,10,3,23,61,124
Citadel6,6,Quayson Williams,JR,G,Citadel,Southern,31,492,69,187,24,47,45,140,38,48,23,66,89,49,34,3,46,46,221
Citadel7,7,Tariq Simmons,FR,G,Citadel,Southern,32,487,87,230,60,138,27,92,27,50,14,53,67,60,25,2,49,27,228
Citadel8,8,Alex Reed,FR,F,Citadel,Southern,32,456,55,142,23,47,32,95,34,48,31,47,78,25,26,3,22,61,176
Citadel9,9,Hayden Brown,FR,F,Citadel,Southern,29,390,56,130,44,87,12,43,26,37,22,57,79,26,23,6,30,55,150
Citadel10,10,Rob Johnson,FR,G,Citadel,Southern,25,256,29,59,28,50,1,9,18,33,28,43,71,12,10,13,20,42,77
Citadel11,11,Derek Webster Jr.,FR,F,Citadel,Southern,27,215,21,40,20,38,1,2,12,25,20,29,49,9,8,8,16,29,55
Citadel12,12,Kaiden Rice,FR,F,Citadel,Southern,23,214,44,130,12,28,32,102,6,8,11,20,31,9,9,0,10,9,126
Citadel13,13,Preston Parks,SO,G,Citadel,Southern,6,162,29,70,15,35,14,35,11,11,6,13,19,25,14,2,10,13,83
Clemson1,1,Marcquise Reed,JR,G,Clemson,ACC,32,1119,163,379,98,200,65,179,116,137,24,123,147,110,54,0,74,58,507
Clemson2,2,Gabe DeVoe,SR,G,Clemson,ACC,32,1100,142,334,67,140,75,194,63,82,28,123,151,63,33,14,62,67,422
Clemson3,3,Shelton Mitchell,JR,G,Clemson,ACC,30,997,110,276,64,150,46,126,93,109,12,76,88,106,23,1,64,44,359
Clemson4,4,Elijah Thomas,JR,F,Clemson,ACC,32,789,134,235,134,235,0,0,77,124,73,181,254,31,21,71,71,102,345
Clemson5,5,Donte Grantham,SR,F,Clemson,ACC,19,605,102,182,76,120,26,62,39,50,30,101,131,45,15,17,31,38,269
Clemson6,6,Aamir Simms,FR,F,Clemson,ACC,31,464,47,104,35,63,12,41,15,26,23,76,99,19,7,26,20,42,121
Clemson7,7,David Skara,,F,Clemson,ACC,23,442,25,62,20,41,5,21,17,26,19,41,60,10,14,10,22,49,72
Clemson8,8,Mark Donnal,SR,F,Clemson,ACC,31,393,42,78,23,41,19,37,14,19,16,38,54,8,7,10,11,53,117
Clemson9,9,Clyde Trapp,FR,G,Clemson,ACC,27,215,16,40,9,20,7,20,14,19,1,18,19,17,2,2,15,22,53
Clemson10,10,Scott Spencer,SO,G,Clemson,ACC,18,137,10,39,7,17,3,22,1,2,3,7,10,5,1,1,3,12,24
Clemson11,11,Anthony Oliver II,FR,G,Clemson,ACC,16,108,9,28,2,9,7,19,9,11,4,15,19,4,4,0,4,14,34
Clemson12,12,Malik William,FR,F,Clemson,ACC,16,72,9,26,8,23,1,3,3,4,14,11,25,3,1,3,2,11,22
Clemson13,13,Lyles Davis,JR,G,Clemson,ACC,2,6,0,2,0,1,0,1,0,0,0,0,0,1,0,0,0,0,0
Clemson14,14,Isaac Fields,SO,G,Clemson,ACC,2,4,0,1,0,0,0,1,0,0,0,1,1,0,0,0,0,0,0
Cleveland State1,1,Kenny Carpenter,SR,G,Cleveland State,Horizon,34,1146,177,372,120,211,57,161,41,58,24,149,173,82,37,15,42,79,452
Cleveland State2,2,Bobby Word,SR,G,Cleveland State,Horizon,35,956,119,300,35,85,84,215,39,56,10,93,103,23,23,7,47,71,361
Cleveland State3,3,Tyree Appleby,FR,G,Cleveland State,Horizon,34,874,129,290,93,179,36,111,106,148,17,65,82,135,44,8,115,68,400
Cleveland State4,4,Stefan Kenic,FR,F,Cleveland State,Horizon,35,815,106,253,57,121,49,132,72,91,26,88,114,20,17,11,64,81,333
Cleveland State5,5,Kasheem Thomas,SO,G,Cleveland State,Horizon,35,737,61,172,46,112,15,60,52,72,6,59,65,79,14,0,50,44,189
Cleveland State6,6,Anthony Wright,SR,F,Cleveland State,Horizon,28,731,85,173,66,111,19,62,35,45,52,110,162,43,31,10,38,61,224
Cleveland State7,7,Jamarcus Hairston,SR,F,Cleveland State,Horizon,35,724,79,161,57,97,22,64,17,30,42,86,128,26,22,15,24,52,197
Cleveland State8,8,Dontel Highsmith,JR,G,Cleveland State,Horizon,26,506,50,124,42,88,8,36,20,28,16,40,56,29,21,2,30,42,128
Cleveland State9,9,Evan Clayborne,SO,F,Cleveland State,Horizon,24,240,32,63,32,63,0,0,8,19,22,28,50,3,6,16,25,48,72
Cleveland State10,10,Terrell Hales,SR,G,Cleveland State,Horizon,26,213,9,23,9,19,0,4,5,9,17,18,35,10,14,4,7,32,23
Cleveland State11,11,Derek Sloan,SR,F,Cleveland State,Horizon,8,59,2,12,2,11,0,1,7,16,4,9,13,6,1,2,7,12,11
Cleveland State12,12,Shawn Christian Jr.,FR,G,Cleveland State,Horizon,11,45,4,18,0,3,4,15,0,0,0,2,2,0,1,0,0,4,12
Cleveland State13,13,David Payne,JR,F,Cleveland State,Horizon,3,4,0,2,0,0,0,2,0,0,1,2,3,0,0,0,0,1,0
Coastal Carolina1,1,Jaylen Shaw,SR,G,Coastal Carolina,Sun Belt,32,989,157,374,123,266,34,108,126,163,10,92,102,172,51,1,112,71,474
Coastal Carolina2,2,Zac Cuthbertson,JR,F,Coastal Carolina,Sun Belt,31,909,141,313,112,217,29,96,144,181,58,152,210,49,29,22,72,85,455
Coastal Carolina3,3,Artur Labinowicz,SO,G,Coastal Carolina,Sun Belt,32,873,97,265,47,117,50,148,103,134,31,109,140,36,22,18,62,55,347
Coastal Carolina4,4,Demario Beck,SR,F,Coastal Carolina,Sun Belt,32,762,124,230,105,162,19,68,45,76,79,150,229,22,16,22,55,98,312
Coastal Carolina5,5,Ajay Sanders,JR,G,Coastal Carolina,Sun Belt,32,752,53,161,18,60,35,101,13,18,24,89,113,39,11,5,44,63,154
Coastal Carolina6,6,Josh Coleman,JR,C,Coastal Carolina,Sun Belt,32,507,51,105,51,104,0,1,9,30,70,56,126,2,3,21,16,75,111
Coastal Carolina7,7,Amidou Bamba,SO,F,Coastal Carolina,Sun Belt,30,425,73,115,73,115,0,0,24,43,41,59,100,12,4,18,21,46,170
Coastal Carolina8,8,Christian Adams,JR,G,Coastal Carolina,Sun Belt,25,373,14,47,10,31,4,16,13,17,4,39,43,16,7,4,30,43,45
Coastal Carolina9,9,Matt Lindsey,JR,G,Coastal Carolina,Sun Belt,17,352,25,81,7,26,18,55,12,17,5,26,31,16,15,1,19,20,80
Coastal Carolina10,10,Tre Brown,FR,G,Coastal Carolina,Sun Belt,30,326,29,69,18,42,11,27,6,7,0,22,22,43,10,0,28,42,75
Coastal Carolina11,11,Tyrell Gumbs-Frater,,G,Coastal Carolina,Sun Belt,14,162,21,48,3,10,18,38,10,14,7,18,25,8,3,3,9,9,70
Coastal Carolina12,12,Bill Muse,JR,G,Coastal Carolina,Sun Belt,4,11,0,2,0,0,0,2,1,2,0,1,1,0,0,0,0,0,1
Coastal Carolina13,13,Josh Peterson,SO,G,Coastal Carolina,Sun Belt,2,9,2,3,2,3,0,0,0,0,0,0,0,3,0,1,2,1,4
Colgate1,1,Sean O'Brien,,G,Colgate,Patriot,32,1079,110,275,53,109,57,166,69,81,22,105,127,119,37,0,32,68,346
Colgate2,2,Will Rayman,SO,F,Colgate,Patriot,32,1025,156,343,92,192,64,151,96,119,61,156,217,34,31,28,53,79,472
Colgate3,3,Jordan Swopshire,SR,F,Colgate,Patriot,32,897,123,296,49,101,74,195,59,77,36,120,156,38,18,7,44,56,379
Colgate4,4,Jordan Burns,FR,G,Colgate,Patriot,30,817,130,301,90,188,40,113,50,67,14,65,79,90,25,3,77,39,350
Colgate5,5,Dana Batt,JR,C,Colgate,Patriot,32,703,95,154,95,153,0,1,37,51,46,94,140,29,19,36,28,80,227
Colgate6,6,Francisco Amiel,JR,G,Colgate,Patriot,32,635,29,95,13,41,16,54,14,17,8,44,52,55,33,5,30,42,88
Colgate7,7,Jordan Robertson,SR,G,Colgate,Patriot,31,403,61,148,47,104,14,44,32,48,21,24,45,13,11,8,27,51,168
Colgate8,8,Malcolm Regisford,JR,F,Colgate,Patriot,24,352,47,74,47,74,0,0,22,34,32,67,99,13,3,14,23,34,116
Colgate9,9,Jack Ferguson,FR,G,Colgate,Patriot,29,284,38,114,7,19,31,95,21,29,6,18,24,16,13,2,8,34,128
Colgate10,10,Sam Lindgren,,F,Colgate,Patriot,11,103,12,17,12,17,0,0,3,3,9,18,27,4,5,3,5,20,27
Colgate11,11,Hugh Baxter,FR,F,Colgate,Patriot,8,41,3,8,2,2,1,6,0,0,2,3,5,2,0,0,3,6,7
Colgate12,12,David Maynard,,G,Colgate,Patriot,6,30,4,5,2,3,2,2,2,2,2,4,6,0,1,0,2,2,12
Colgate13,13,Milan Williams,,G,Colgate,Patriot,4,17,0,1,0,1,0,0,4,4,0,2,2,0,0,0,1,4,4
Colgate14,14,Tom Rivard,,F,Colgate,Patriot,1,8,0,1,0,1,0,0,0,0,0,0,0,1,0,0,1,2,0
Colgate15,15,Dylan Whitbread,,F,Colgate,Patriot,2,4,1,1,1,1,0,0,0,0,0,0,0,0,0,0,1,1,2
Colgate16,16,David Favorite,,G,Colgate,Patriot,1,2,0,0,0,0,0,0,0,0,0,0,0,0,0,0,0,0,0
College of Charleston1,1,Joe Chealey,SR,G,College of Charleston,CAA,33,1182,168,427,106,250,62,177,211,245,22,133,155,120,28,4,56,73,609
College of Charleston2,2,Cameron Johnson,SR,G,College of Charleston,CAA,33,1090,105,229,60,115,45,114,37,61,26,86,112,59,25,12,42,73,292
College of Charleston3,3,Grant Riller,SO,G,College of Charleston,CAA,32,1070,224,407,170,273,54,134,95,129,13,72,85,66,41,14,57,66,597
College of Charleston4,4,Marquise Pointer,JR,G,College of Charleston,CAA,33,816,64,161,38,81,26,80,31,44,25,72,97,59,25,6,29,48,185
College of Charleston5,5,Nick Harris,JR,F,College of Charleston,CAA,32,816,78,141,78,141,0,0,36,58,62,145,207,13,13,40,35,90,192
College of Charleston6,6,Jarrell Brantley,,F,College of Charleston,CAA,23,737,144,290,116,217,28,73,74,88,42,121,163,38,25,18,56,69,390
College of Charleston7,7,Jaylen McManus,SO,F,College of Charleston,CAA,33,497,36,103,13,34,23,69,17,28,20,63,83,14,4,14,11,45,112
College of Charleston8,8,Evan Bailey,SR,F,College of Charleston,CAA,25,237,20,55,5,11,15,44,9,11,6,23,29,4,5,0,8,24,64
College of Charleston9,9,Osinachi Smart,FR,F,College of Charleston,CAA,20,168,8,19,8,19,0,0,9,16,17,30,47,3,5,6,4,31,25
College of Charleston10,10,Samba Ndiaye,FR,C,College of Charleston,CAA,20,76,3,11,3,11,0,0,1,4,11,14,25,0,0,5,6,18,7
College of Charleston11,11,Brevin Galloway,FR,G,College of Charleston,CAA,7,30,1,6,0,0,1,6,0,0,0,6,6,1,0,0,0,3,3
College of Charleston12,12,Jermaine Blackmon Jr.,,F,College of Charleston,CAA,3,3,0,2,0,1,0,1,0,0,0,0,0,0,0,0,0,0,0
College of Charleston13,13,Trent Robinson,,G,College of Charleston,CAA,2,3,1,3,1,2,0,1,0,1,0,1,1,0,0,0,0,0,2
Colorado1,1,McKinley Wright IV,FR,G,Colorado,Pac-12,32,1042,166,368,138,276,28,92,94,122,52,97,149,175,31,14,94,49,454
Colorado2,2,George King,SR,G,Colorado,Pac-12,32,913,142,319,80,162,62,157,68,87,56,194,250,35,17,21,64,78,414
Colorado3,3,Namon Wright,JR,G,Colorado,Pac-12,30,688,103,237,74,150,29,87,56,75,19,85,104,34,15,8,57,48,291
Colorado4,4,Dominique Collier,SR,G,Colorado,Pac-12,32,632,71,184,29,76,42,108,56,77,8,40,48,46,18,0,42,82,240
Colorado5,5,Tyler Bey,FR,G,Colorado,Pac-12,32,629,73,146,73,139,0,7,50,73,48,115,163,16,20,22,38,84,196
Colorado6,6,Dallas Walton,FR,F,Colorado,Pac-12,30,557,70,152,65,139,5,13,26,37,27,75,102,21,7,34,28,59,171
Colorado7,7,Lucas Siewert,SO,F,Colorado,Pac-12,30,551,66,136,36,69,30,67,42,51,28,62,90,22,8,13,27,64,204
Colorado8,8,Lazar Nikolic,FR,G,Colorado,Pac-12,31,480,27,71,19,37,8,34,10,22,11,61,72,30,9,5,28,59,72
Colorado9,9,D'Shawn Schwartz,,G,Colorado,Pac-12,32,418,38,90,20,43,18,47,14,19,5,54,59,9,3,0,10,33,108
Colorado10,10,Deleon Brown,SO,G,Colorado,Pac-12,23,418,39,112,20,52,19,60,17,24,4,24,28,18,11,4,25,48,114
Colorado11,11,Tory Miller-Stewart,SR,F,Colorado,Pac-12,6,133,12,18,12,18,0,0,13,23,7,21,28,2,1,1,15,11,37
Colorado12,12,Alexander Strating,FR,F,Colorado,Pac-12,5,7,3,5,3,5,0,0,0,2,2,2,4,0,0,0,2,3,6
Colorado13,13,Josh Repine,SR,G,Colorado,Pac-12,5,6,0,2,0,1,0,1,0,0,1,0,1,1,0,0,0,0,0
Colorado14,14,A.J. Martinka,,G,Colorado,Pac-12,1,1,0,0,0,0,0,0,0,0,0,0,0,0,0,0,1,1,0
Colorado State1,1,Nico Carvacho,SO,F,Colorado State,MWC,32,919,107,211,101,195,6,16,73,120,124,206,330,71,23,22,64,107,293
Colorado State2,2,Prentiss Nixon,JR,G,Colorado State,MWC,27,867,133,370,67,170,66,200,102,121,8,78,86,53,40,3,56,71,434
Colorado State3,3,Anthony Bonner,SO,G,Colorado State,MWC,32,866,99,221,58,126,41,95,46,56,8,78,86,43,20,2,45,69,285
Colorado State4,4,Che Bob,SR,F,Colorado State,MWC,32,807,105,244,87,182,18,62,90,133,56,134,190,56,31,38,76,94,318
Colorado State5,5,Deion James,JR,F,Colorado State,MWC,31,800,125,276,112,226,13,50,58,82,71,94,165,51,20,19,55,97,321
Colorado State6,6,J.D. Paige,,G,Colorado State,MWC,23,721,85,241,51,127,34,114,36,46,17,52,69,58,27,6,57,51,240
Colorado State7,7,Raquan Mitchell,SO,G,Colorado State,MWC,30,692,83,203,73,150,10,53,33,45,17,69,86,49,19,6,27,46,209
Colorado State8,8,Lorenzo Jenkins,SO,G,Colorado State,MWC,31,423,39,97,17,43,22,54,11,20,15,49,64,5,3,3,20,35,111
Colorado State9,9,Robbie Berwick,JR,G,Colorado State,MWC,21,203,17,45,9,21,8,24,10,14,4,8,12,17,6,0,7,19,52
Colorado State10,10,Logan Ryan,FR,F,Colorado State,MWC,21,173,17,30,10,15,7,15,8,14,12,23,35,6,1,3,4,31,49
Colorado State11,11,Juan Sabino II,,G,Colorado State,MWC,2,4,1,3,1,2,0,1,0,0,2,1,3,0,0,0,0,4,2
Columbia1,1,Mike Smith,SO,G,Columbia,Ivy,27,918,157,403,108,244,49,159,112,133,12,58,70,124,31,1,59,49,475
Columbia2,2,Quinton Adlesh,JR,G,Columbia,Ivy,27,796,112,241,40,78,72,163,13,19,14,79,93,63,29,1,41,44,309
Columbia3,3,Nate Hickman,SR,G,Columbia,Ivy,27,735,76,207,45,102,31,105,52,66,11,74,85,38,18,5,43,56,235
Columbia4,4,Lukas Meisner,JR,F,Columbia,Ivy,25,688,106,212,63,109,43,103,25,42,36,151,187,46,13,11,48,72,280
Columbia5,5,Patrick Tape,SO,F,Columbia,Ivy,25,430,48,89,48,89,0,0,15,28,58,70,128,12,16,31,35,78,111
Columbia6,6,Kyle Castlin,SR,G,Columbia,Ivy,17,418,63,127,48,84,15,43,38,43,19,46,65,24,22,4,19,34,179
Columbia7,7,Jaron Faulds,FR,F,Columbia,Ivy,26,369,53,89,53,89,0,0,10,23,33,51,84,10,8,26,21,44,116
Columbia8,8,Gabe Stefanini,FR,G,Columbia,Ivy,27,354,61,137,35,80,26,57,12,19,19,33,52,27,21,2,31,42,160
Columbia9,9,Rodney Hunter,JR,F,Columbia,Ivy,26,214,13,25,13,22,0,3,7,12,14,35,49,17,10,7,17,30,33
Columbia10,10,Myles Hanson,FR,F,Columbia,Ivy,19,200,21,64,9,21,12,43,5,5,8,35,43,8,5,4,8,18,59
Columbia11,11,Tai Bibbs,FR,G,Columbia,Ivy,13,159,13,39,6,16,7,23,11,16,4,13,17,5,2,0,4,14,44
Columbia12,12,Peter Barba,JR,G,Columbia,Ivy,12,86,11,26,2,5,9,21,0,0,3,7,10,3,2,0,2,11,31
Columbia13,13,Randy Brumant,,F,Columbia,Ivy,7,45,5,9,5,9,0,0,1,1,7,7,14,4,0,1,2,8,11
Columbia14,14,Luke Bolster,,G,Columbia,Ivy,4,25,3,12,1,4,2,8,0,0,0,3,3,3,0,0,1,1,8
Columbia15,15,Jake Killingsworth,SO,G,Columbia,Ivy,2,13,4,6,1,1,3,5,0,0,2,2,4,0,0,0,2,3,11
Connecticut1,1,Jalen Adams,JR,G,Connecticut,AAC,30,1144,207,483,159,335,48,148,78,98,26,101,127,141,46,10,87,48,540
Connecticut2,2,Christian Vital,SO,G,Connecticut,AAC,32,1013,138,360,70,146,68,214,132,156,25,146,171,53,50,1,56,73,476
Connecticut3,3,Antwoine Anderson,SR,G,Connecticut,AAC,32,1004,77,197,51,101,26,96,56,75,13,78,91,65,34,5,51,93,236
Connecticut4,4,Terry Larrier,JR,G,Connecticut,AAC,29,987,148,372,97,237,51,135,56,71,38,100,138,25,20,7,69,48,403
Connecticut5,5,Josh Carlton,FR,F,Connecticut,AAC,32,485,57,111,57,111,0,0,28,42,55,63,118,10,10,24,31,79,142
Connecticut6,6,Tyler Polley,FR,F,Connecticut,AAC,32,425,24,75,9,39,15,36,24,32,8,28,36,5,3,5,18,32,87
Connecticut7,7,Isaiah Whaley,FR,F,Connecticut,AAC,30,414,30,53,30,53,0,0,19,28,34,33,67,10,11,30,12,47,79
Connecticut8,8,Mamadou Diarra,FR,F,Connecticut,AAC,31,314,34,62,34,62,0,0,15,30,32,47,79,0,4,22,14,70,83
Connecticut9,9,David Onuorah,SR,F,Connecticut,AAC,30,311,12,25,12,24,0,1,6,11,29,33,62,4,0,12,25,64,30
Connecticut10,10,Alterique Gilbert,FR,G,Connecticut,AAC,6,167,19,60,14,38,5,22,11,20,1,23,24,17,7,2,9,8,54
Connecticut11,11,Eric Cobb,JR,F,Connecticut,AAC,15,116,8,18,6,14,2,4,8,14,8,34,42,3,3,1,18,17,26
Connecticut12,12,Kwintin Williams,SO,F,Connecticut,AAC,18,113,8,14,8,12,0,2,9,16,15,19,34,1,2,0,3,13,25
Connecticut13,13,Mike Noyes,SR,G,Connecticut,AAC,6,6,0,2,0,1,0,1,0,0,0,0,0,0,0,0,0,0,0
Connecticut14,14,Christian Foxen,SR,F,Connecticut,AAC,2,1,0,0,0,0,0,0,0,0,0,0,0,0,0,0,0,0,0
Coppin State1,1,Karonn Davis,SR,G,Coppin State,MEAC,32,1007,127,371,85,216,42,155,78,99,21,105,126,146,32,3,80,67,374
Coppin State2,2,Lamar Morgan,JR,G,Coppin State,MEAC,31,964,118,308,30,70,88,238,57,70,13,145,158,13,23,6,52,85,381
Coppin State3,3,Cedric Council Jr.,JR,F,Coppin State,MEAC,32,776,70,177,54,117,16,60,22,37,49,81,130,24,23,30,30,90,178
Coppin State4,4,Chad Andrews-Fulton,JR,F,Coppin State,MEAC,30,616,66,145,66,142,0,3,57,89,59,84,143,25,21,11,49,96,189
Coppin State5,5,Adam Traore,JR,F,Coppin State,MEAC,25,550,47,132,40,99,7,33,60,76,33,107,140,31,8,6,52,84,161
Coppin State6,6,Tre' Thomas,,G,Coppin State,MEAC,28,543,55,177,32,88,23,89,19,21,5,40,45,23,10,1,37,40,152
Coppin State7,7,Taqwain Drummond,FR,G,Coppin State,MEAC,20,417,23,91,11,47,12,44,15,20,8,41,49,11,11,2,19,38,73
Coppin State8,8,Kent Auslander,,G,Coppin State,MEAC,17,400,22,84,11,29,11,55,12,20,3,38,41,15,4,4,33,31,67
Coppin State9,9,Keandre Fair,FR,G,Coppin State,MEAC,27,387,29,87,4,11,25,76,5,8,1,29,30,18,21,0,9,25,88
Coppin State10,10,Lucian Brownlee,JR,G,Coppin State,MEAC,30,356,48,122,17,44,31,78,20,23,3,23,26,17,8,1,32,38,147
Coppin State11,11,Dejuan Clayton,SO,G,Coppin State,MEAC,6,179,21,63,12,35,9,28,10,15,2,9,11,11,6,1,11,12,61
Coppin State12,12,Jordan Hardwick,,F,Coppin State,MEAC,14,158,14,34,13,26,1,8,3,6,14,17,31,0,1,13,12,23,32
Coppin State13,13,Blake Simpson,,F,Coppin State,MEAC,12,96,7,15,7,15,0,0,6,6,3,9,12,1,0,4,5,12,20
Coppin State14,14,Joel Boyce,FR,G,Coppin State,MEAC,6,75,10,18,10,16,0,2,2,5,2,10,12,3,4,0,11,8,22
Coppin State15,15,Donnell Frayer,,G,Coppin State,MEAC,2,1,0,1,0,0,0,1,0,0,0,0,0,0,0,0,0,0,0
Cornell1,1,Matt Morgan,JR,G,Cornell,Ivy,28,969,204,415,129,212,75,203,147,180,11,118,129,90,23,9,69,48,630
Cornell2,2,Steven Julian,JR,F,Cornell,Ivy,28,834,71,138,61,107,10,31,38,67,38,124,162,33,32,39,28,81,190
Cornell3,3,Stone Gettings,JR,F,Cornell,Ivy,28,749,164,338,121,221,43,117,94,114,39,147,186,80,20,13,63,79,465
Cornell4,4,Jack Gordon,JR,G,Cornell,Ivy,27,684,63,132,23,39,40,93,27,39,16,49,65,52,14,1,47,56,193
Cornell5,5,Terrance McBride,FR,G,Cornell,Ivy,26,684,49,88,40,61,9,27,21,28,10,52,62,68,13,1,24,33,128
Cornell6,6,Joel Davis,JR,G,Cornell,Ivy,28,494,46,122,38,88,8,34,32,49,19,50,69,30,24,10,32,46,132
Cornell7,7,Josh Warren,SO,F,Cornell,Ivy,28,436,46,105,42,87,4,18,19,24,18,66,84,45,5,9,45,70,115
Cornell8,8,Jimmy Boeheim,FR,F,Cornell,Ivy,26,310,32,98,26,58,6,40,13,21,18,39,57,13,1,6,10,28,83
Cornell9,9,Wil Bathurst,SR,G,Cornell,Ivy,7,172,19,49,16,32,3,17,9,13,5,20,25,22,3,5,13,10,50
Cornell10,10,Bryan Knapp,FR,G,Cornell,Ivy,16,146,19,47,14,36,5,11,7,10,3,4,7,6,4,0,13,13,50
Cornell11,11,Jake Kuhn,FR,G,Cornell,Ivy,16,88,13,33,6,13,7,20,4,9,5,8,13,3,0,0,5,7,37
Cornell12,12,Kyle Brown,SR,G,Cornell,Ivy,21,76,7,22,3,6,4,16,2,5,3,6,9,1,3,3,4,12,20
Cornell13,13,Jordan Abdur-Ra'oof,,F,Cornell,Ivy,13,72,10,20,7,10,3,10,4,10,0,6,6,4,2,1,5,10,27
Cornell14,14,Riley Voss,FR,F,Cornell,Ivy,6,37,1,6,1,4,0,2,2,5,5,4,9,2,0,0,4,5,4
Creighton1,1,Marcus Foster,SR,G,Creighton,Big East,32,1011,244,498,150,275,94,223,67,90,21,103,124,87,33,4,68,54,649
Creighton2,2,Khyri Thomas,JR,G,Creighton,Big East,32,1009,180,333,118,185,62,148,66,83,34,103,137,88,53,8,57,58,488
Creighton3,3,Ronnie Harrell,JR,G,Creighton,Big East,29,746,71,152,53,98,18,54,47,59,35,151,186,79,16,6,38,46,207
Creighton4,4,Mitchell Ballock,FR,G,Creighton,Big East,32,675,83,195,43,71,40,124,19,24,7,80,87,63,23,7,37,48,225
Creighton5,5,Davion Mintz,SO,G,Creighton,Big East,32,666,57,141,40,89,17,52,60,82,7,92,99,99,14,3,36,42,191
Creighton6,6,Toby Hegner,SR,F,Creighton,Big East,29,654,87,173,52,84,35,89,32,38,23,63,86,25,7,15,20,67,241
Creighton7,7,Ty-Shon Alexander,FR,G,Creighton,Big East,32,573,60,141,29,49,31,92,29,41,4,61,65,57,9,4,39,28,180
Creighton8,8,Martin Krampelj,SO,F,Creighton,Big East,19,441,94,140,88,117,6,23,33,53,41,112,153,23,16,13,25,52,227
Creighton9,9,Manny Suarez,SR,C,Creighton,Big East,23,179,29,65,24,45,5,20,10,15,15,46,61,9,1,13,11,32,73
Creighton10,10,Tyler Clement,SR,G,Creighton,Big East,20,173,20,43,7,10,13,33,5,5,3,16,19,19,2,2,7,24,58
Creighton11,11,Jacob Epperson,,C,Creighton,Big East,11,152,33,46,29,42,4,4,3,9,5,29,34,3,2,10,3,15,73
Creighton12,12,Kaleb Joseph,JR,G,Creighton,Big East,14,115,19,33,14,22,5,11,22,27,3,13,16,21,4,0,10,10,65
Creighton13,13,Jordan Scurry,SO,G,Creighton,Big East,16,56,8,22,4,6,4,16,0,0,3,10,13,3,1,0,4,4,20
Dartmouth1,1,Brendan Barry,SO,G,Dartmouth,Ivy,27,944,87,204,34,84,53,120,38,44,7,62,69,105,19,3,41,48,265
Dartmouth2,2,Miles Wright,SR,G,Dartmouth,Ivy,27,873,113,272,63,127,50,145,57,69,18,100,118,29,41,17,42,68,333
Dartmouth3,3,Taylor Johnson,SR,G,Dartmouth,Ivy,27,776,120,231,91,148,29,83,53,71,16,84,100,79,28,2,75,57,322
Dartmouth4,4,Will Emery,SO,F,Dartmouth,Ivy,26,609,65,141,63,122,2,19,64,99,38,83,121,23,4,20,40,36,196
Dartmouth5,5,Chris Knight,FR,F,Dartmouth,Ivy,25,536,103,198,103,196,0,2,47,77,33,68,101,28,16,27,50,63,253
Dartmouth6,6,Aaryn Rai,FR,G,Dartmouth,Ivy,25,459,39,107,18,59,21,48,22,30,30,44,74,20,16,6,28,48,121
Dartmouth7,7,Ian Sistare,SO,G,Dartmouth,Ivy,27,363,30,83,13,31,17,52,15,23,9,40,49,24,3,2,25,20,92
Dartmouth8,8,Adrease Jackson,FR,F,Dartmouth,Ivy,26,324,55,104,38,71,17,33,17,26,23,78,101,9,5,8,20,40,144
Dartmouth9,9,James Foye,SO,G,Dartmouth,Ivy,25,263,12,45,4,8,8,37,5,6,1,22,23,14,7,1,9,22,37
Dartmouth10,10,Isaac Letoa,FR,G,Dartmouth,Ivy,16,109,6,18,6,14,0,4,5,10,1,8,9,14,6,1,10,3,17
Dartmouth11,11,Guilien Smith,JR,G,Dartmouth,Ivy,3,81,10,29,8,20,2,9,9,9,1,6,7,4,2,0,5,7,31
Dartmouth12,12,Cameron Smith,SR,G,Dartmouth,Ivy,15,72,8,18,7,13,1,5,7,11,1,5,6,6,3,0,5,7,24
Dartmouth13,13,Ben Swett,FR,G,Dartmouth,Ivy,6,8,0,1,0,1,0,0,0,0,0,2,2,2,2,0,0,1,0
Dartmouth14,14,Joseph Cook,,F,Dartmouth,Ivy,6,8,3,3,3,3,0,0,0,0,2,3,5,0,0,0,0,1,6
Davidson1,1,Peyton Aldridge,SR,F,Davidson,A-10,31,1165,243,497,167,305,76,192,114,135,44,197,241,78,13,19,39,48,676
Davidson2,2,Jon Axel Gudmundsson,SO,G,Davidson,A-10,31,1102,135,291,78,147,57,144,80,100,13,174,187,160,42,1,67,52,407
Davidson3,3,Kellan Grady,FR,G,Davidson,A-10,31,1084,209,410,139,224,70,186,72,91,21,80,101,61,25,3,31,64,560
Davidson4,4,KiShawn Pritchett,SO,G,Davidson,A-10,31,778,62,131,28,52,34,79,22,24,21,46,67,108,17,8,55,52,180
Davidson5,5,Will Magarity,SR,F,Davidson,A-10,30,599,71,130,50,77,21,53,6,11,37,88,125,18,13,17,27,56,169
Davidson6,6,Rusty Reigel,SR,G,Davidson,A-10,31,592,40,76,12,22,28,54,15,20,17,63,80,55,17,1,22,59,123
Davidson7,7,Oskar Michelsen,SR,F,Davidson,A-10,31,517,59,125,24,36,35,89,16,22,19,57,76,20,13,8,18,84,169
Davidson8,8,Carter Collins,FR,G,Davidson,A-10,24,162,14,38,11,17,3,21,5,10,6,13,19,10,3,1,9,24,36
Davidson9,9,Jordan Watkins,SR,G,Davidson,A-10,16,99,10,25,1,3,9,22,0,0,1,8,9,8,4,0,5,7,29
Davidson10,10,Dusan Kovacevic,SO,F,Davidson,A-10,7,75,9,22,8,17,1,5,5,7,2,17,19,3,1,1,5,12,24
Davidson11,11,Bates Jones,FR,F,Davidson,A-10,18,46,2,9,2,6,0,3,0,0,5,11,16,8,0,0,2,6,4
Davidson12,12,Malcolm Wynter,SO,G,Davidson,A-10,16,26,2,6,0,1,2,5,3,4,1,1,2,0,0,0,1,1,9
Davidson13,13,Cal Freundlich,SO,G,Davidson,A-10,11,16,0,2,0,0,0,2,2,4,0,4,4,0,1,0,0,1,2
Davidson14,14,Michael Brown,SO,G,Davidson,A-10,11,14,0,1,0,0,0,1,0,0,0,0,0,1,0,0,0,1,0
Dayton1,1,Darrell Davis,SR,G,Dayton,A-10,31,1088,150,345,78,156,72,189,105,120,15,111,126,85,21,3,84,69,477
Dayton2,2,Josh Cunningham,JR,F,Dayton,A-10,31,981,186,288,178,254,8,34,103,149,79,182,261,54,16,13,71,96,483
Dayton3,3,Jalen Crutcher,FR,G,Dayton,A-10,31,967,100,243,48,89,52,154,32,47,9,87,96,135,32,4,64,72,284
Dayton4,4,Jordan Davis,FR,G,Dayton,A-10,31,891,88,208,32,66,56,142,17,23,6,51,57,57,32,4,23,29,249
Dayton5,5,Trey Landers,SO,G,Dayton,A-10,29,837,126,216,107,162,19,54,58,80,65,97,162,52,31,11,57,77,329
Dayton6,6,Kostas Antetokounmpo,FR,F,Dayton,A-10,29,438,58,101,56,86,2,15,33,64,24,59,83,13,7,31,39,66,151
Dayton7,7,John Crosby,JR,G,Dayton,A-10,26,383,34,86,25,55,9,31,29,36,4,33,37,49,6,0,31,32,106
Dayton8,8,Xeyrius Williams,JR,F,Dayton,A-10,18,334,33,95,16,33,17,62,7,8,10,45,55,26,8,10,17,23,90
Dayton9,9,Matej Svoboda,FR,F,Dayton,A-10,28,318,25,76,16,31,9,45,2,2,9,24,33,17,4,2,25,44,61
Dayton10,10,Jack Westerfield,JR,G,Dayton,A-10,10,46,2,9,0,2,2,7,2,2,1,1,2,0,2,0,0,2,8
Dayton11,11,Joey Gruden,SR,G,Dayton,A-10,6,10,1,2,0,0,1,2,0,0,0,0,0,0,1,0,2,0,3
Dayton12,12,Jordan Pierce,,C,Dayton,A-10,2,4,0,0,0,0,0,0,0,0,0,1,1,0,0,0,0,0,0
Dayton13,13,Camron Greer,,G,Dayton,A-10,4,2,1,1,0,0,1,1,0,0,0,0,0,0,1,0,0,0,3
Dayton14,14,Dalton Stewart,,G,Dayton,A-10,3,1,0,1,0,1,0,0,0,0,1,0,1,0,1,0,0,0,0
Delaware1,1,Ryan Allen,FR,G,Delaware,CAA,30,1072,163,401,77,180,86,221,47,65,8,67,75,45,15,6,49,86,459
Delaware2,2,Ryan Daly,SO,G,Delaware,CAA,28,1049,178,413,132,265,46,148,87,137,40,133,173,67,33,3,35,60,489
Delaware3,3,Anthony Mosley,SR,G,Delaware,CAA,32,1035,112,232,112,226,0,6,106,151,29,107,136,93,40,11,63,74,330
Delaware4,4,Darian Bryant,JR,G,Delaware,CAA,31,919,74,181,54,104,20,77,12,31,14,66,80,53,22,6,41,50,180
Delaware5,5,Eric Carter,JR,F,Delaware,CAA,30,869,121,204,121,203,0,1,88,134,71,201,272,53,17,25,60,95,330
Delaware6,6,Chyree Walker,FR,F,Delaware,CAA,30,486,50,122,45,101,5,21,11,31,30,42,72,17,13,1,25,51,116
Delaware7,7,Kevin Anderson,FR,G,Delaware,CAA,11,365,51,114,31,61,20,53,29,38,11,43,54,32,13,8,18,33,151
Delaware8,8,Jacob Cushing,SO,F,Delaware,CAA,22,337,31,80,17,29,14,51,6,7,6,45,51,9,4,2,14,37,82
Delaware9,9,Skye Johnson,SR,F,Delaware,CAA,30,335,56,88,56,88,0,0,29,41,46,42,88,9,6,9,23,45,141
Delaware10,10,Derrick Woods,SO,F,Delaware,CAA,9,135,21,35,20,33,1,2,9,16,11,34,45,5,1,4,13,19,52
Delaware11,11,Connor Rufo,FR,G,Delaware,CAA,13,27,2,5,2,4,0,1,3,4,2,4,6,3,0,0,0,4,7
Delaware12,12,Curtis Lochner,JR,G,Delaware,CAA,11,21,0,5,0,2,0,3,1,2,0,1,1,0,0,0,3,0,1
Delaware State1,1,Johquin Wiley,FR,PG,Delaware State,MEAC,32,1144,98,271,58,140,40,131,36,55,10,50,60,90,48,1,83,47,272
Delaware State2,2,Artem Tavakalyan,SR,F,Delaware State,MEAC,32,880,121,264,76,157,45,107,59,77,42,134,176,49,29,6,58,71,346
Delaware State3,3,Simon Okolue,JR,F,Delaware State,MEAC,27,720,134,219,134,218,0,1,43,68,77,114,191,7,16,29,43,88,311
Delaware State4,4,Kavon Waller,,F,Delaware State,MEAC,25,711,63,193,26,67,37,126,11,18,19,73,92,45,6,9,36,41,174
Delaware State5,5,Johnathan Walker,,G,Delaware State,MEAC,27,708,78,181,61,123,17,58,42,60,22,32,54,57,30,3,52,59,215
Delaware State6,6,Marquise Collins,FR,F,Delaware State,MEAC,28,542,84,203,53,119,31,84,52,63,18,60,78,16,7,6,42,53,251
Delaware State7,7,Joseph Lewis,,C,Delaware State,MEAC,27,446,47,130,42,109,5,21,15,30,8,67,75,25,6,9,50,54,114
Delaware State8,8,Demola Onifade,JR,C,Delaware State,MEAC,28,332,13,48,13,48,0,0,1,2,19,45,64,6,3,9,15,41,27
Delaware State9,9,Ameer Bennett,FR,F,Delaware State,MEAC,29,310,28,67,28,67,0,0,29,47,26,29,55,7,7,4,35,41,85
Delaware State10,10,Saleik Edwards,JR,G,Delaware State,MEAC,25,196,18,63,14,34,4,29,11,15,7,11,18,5,8,0,11,20,51
Delaware State11,11,Kobe Gantz,SO,G,Delaware State,MEAC,6,183,23,58,15,39,8,19,27,36,9,22,31,20,16,0,15,16,81
Delaware State12,12,Jonathan Mitchell,SO,G,Delaware State,MEAC,9,156,20,42,18,36,2,6,20,30,10,10,20,19,6,3,12,8,62
Delaware State13,13,Daivon Gamble,JR,C,Delaware State,MEAC,11,100,9,21,8,19,1,2,9,11,6,11,17,1,4,4,4,13,28
Delaware State14,14,Myles Carter,FR,G,Delaware State,MEAC,12,36,2,9,2,8,0,1,2,2,1,1,2,1,1,0,11,4,6
Delaware State15,15,Matthew Stevenson,FR,G,Delaware State,MEAC,9,21,2,7,0,1,2,6,1,2,0,1,1,0,2,0,2,3,7
Delaware State16,16,Reginald Giles,SO,C,Delaware State,MEAC,2,15,2,5,2,5,0,0,0,0,1,3,4,0,0,0,0,1,4
Denver1,1,Joe Rosga,JR,G,Denver,Summit,30,1025,155,322,82,156,73,166,100,111,19,105,124,88,22,2,65,50,483
Denver2,2,Jake Pemberton,SR,G,Denver,Summit,30,977,119,253,63,129,56,124,39,48,7,91,98,85,38,4,55,75,333
Denver3,3,Daniel Amigo,SR,C,Denver,Summit,30,774,189,363,171,319,18,44,63,106,67,132,199,46,9,22,89,96,459
Denver4,4,Ade Murkey,SO,G,Denver,Summit,30,744,86,202,85,194,1,8,52,81,44,83,127,83,21,13,72,66,225
Denver5,5,Jake Krafka,SO,F,Denver,Summit,30,688,54,135,40,86,14,49,40,60,36,130,166,62,6,9,36,86,162
Denver6,6,Jake Holtzmann,JR,G,Denver,Summit,26,366,28,73,8,21,20,52,18,21,7,33,40,29,5,2,26,22,94
Denver7,7,Donoven Carlisle,FR,F,Denver,Summit,26,342,25,42,23,38,2,4,8,13,14,58,72,3,5,4,14,38,60
Denver8,8,Abiola Akintola,JR,F,Denver,Summit,29,321,25,50,25,50,0,0,6,21,19,44,63,12,7,6,14,50,56
Denver9,9,Christian Mackey,SR,C,Denver,Summit,29,268,47,77,47,75,0,2,17,25,36,37,73,6,1,6,24,41,111
Denver10,10,Elvin Rodriguez,FR,G,Denver,Summit,24,245,36,103,31,77,5,26,26,47,8,20,28,16,11,2,22,24,103
Denver11,11,Luke Neff,SO,G,Denver,Summit,23,166,20,42,5,5,15,37,3,4,1,15,16,10,0,0,7,7,58
Denver12,12,Thomas Neff,,G,Denver,Summit,15,162,14,31,7,16,7,15,3,3,4,10,14,11,4,2,13,5,38
Denver13,13,Emil Knighton,JR,F,Denver,Summit,9,15,3,5,3,5,0,0,0,0,1,2,3,1,0,0,0,0,6
Denver14,14,Elijah Blake,,G,Denver,Summit,1,7,2,2,2,2,0,0,0,0,0,1,1,0,0,0,0,1,4
DePaul1,1,Max Strus,JR,G,DePaul,Big East,31,1106,171,419,90,176,81,243,98,122,48,127,175,85,40,16,82,90,521
DePaul2,2,Eli Cain,JR,G,DePaul,Big East,31,1027,126,362,90,247,36,115,76,115,19,96,115,146,29,8,73,61,364
DePaul3,3,Tre'Darius McCallum,,F,DePaul,Big East,31,909,130,285,104,193,26,92,24,38,44,134,178,29,41,13,45,81,310
DePaul4,4,Brandon Cyrus,SO,G,DePaul,Big East,31,823,80,195,62,143,18,52,45,65,54,53,107,50,16,11,39,60,223
DePaul5,5,Marin Maric,SR,C,DePaul,Big East,28,768,138,249,128,219,10,30,96,114,57,129,186,34,21,13,68,73,382
DePaul6,6,Justin Roberts,FR,G,DePaul,Big East,30,451,51,133,39,96,12,37,15,21,8,29,37,62,15,3,45,29,129
DePaul7,7,Paul Reed,FR,F,DePaul,Big East,28,284,43,83,40,69,3,14,11,19,27,59,86,10,15,13,15,49,100
DePaul8,8,Jaylen Butz,FR,F,DePaul,Big East,23,271,32,52,32,52,0,0,16,33,40,56,96,8,5,12,19,49,80
DePaul9,9,Devin Gage,SO,G,DePaul,Big East,8,193,18,51,17,46,1,5,10,15,2,14,16,22,10,1,17,16,47
DePaul10,10,Peter Ryckbosch,SR,F,DePaul,Big East,18,160,17,26,17,26,0,0,1,9,18,22,40,0,5,3,4,23,35
DePaul11,11,Austin Grandstaff,SO,G,DePaul,Big East,20,148,9,47,2,9,7,38,2,4,3,10,13,16,2,1,12,11,27
DePaul12,12,Joe Hanel,SR,F,DePaul,Big East,14,73,4,10,4,10,0,0,2,5,5,7,12,3,1,0,1,11,10
DePaul13,13,Tobias Dwumaah,,F,DePaul,Big East,5,9,0,0,0,0,0,0,2,2,1,0,1,0,0,0,0,0,2
Detroit Mercy1,1,Kameron Chatman,JR,G,Detroit Mercy,Horizon,29,945,183,388,123,243,60,145,90,106,41,197,238,61,36,11,59,75,516
Detroit Mercy2,2,Jermaine Jackson Jr.,FR,G,Detroit Mercy,Horizon,30,893,102,301,49,122,53,179,57,67,15,76,91,80,34,3,54,55,314
Detroit Mercy3,3,Corey Allen,SO,G,Detroit Mercy,Horizon,29,815,140,324,80,167,60,157,79,100,13,79,92,64,20,1,68,53,419
Detroit Mercy4,4,Josh McFolley,JR,G,Detroit Mercy,Horizon,32,804,118,289,65,134,53,155,65,83,16,55,71,48,49,2,42,83,354
Detroit Mercy5,5,Roschon Prince,SR,F,Detroit Mercy,Horizon,31,690,104,188,104,182,0,6,76,104,72,89,161,38,20,13,39,77,284
Detroit Mercy6,6,DeShawndre Black,SR,G,Detroit Mercy,Horizon,32,561,50,133,31,76,19,57,27,35,16,41,57,57,22,2,41,72,146
Detroit Mercy7,7,Cole Long,SO,F,Detroit Mercy,Horizon,30,501,40,106,23,55,17,51,18,26,24,54,78,41,8,21,26,50,115
Detroit Mercy8,8,Jack Ballantyne,FR,F,Detroit Mercy,Horizon,24,284,16,57,7,20,9,37,11,12,7,35,42,19,2,1,18,26,52
Detroit Mercy9,9,Jaleel Hogan,SR,F,Detroit Mercy,Horizon,18,283,56,96,56,96,0,0,25,51,21,36,57,12,5,6,25,55,137
Detroit Mercy10,10,Gerald Blackshear,JR,F,Detroit Mercy,Horizon,20,191,25,39,25,39,0,0,2,5,23,32,55,3,9,7,20,40,52
Detroit Mercy11,11,Tariiq Jones,JR,F,Detroit Mercy,Horizon,7,133,26,54,20,37,6,17,10,15,10,22,32,8,0,2,16,11,68
Detroit Mercy12,12,Malik Eichler,SO,F,Detroit Mercy,Horizon,18,130,10,22,8,15,2,7,4,6,7,11,18,0,3,1,7,19,26
Detroit Mercy13,13,Isaiah Jones,SR,C,Detroit Mercy,Horizon,15,121,10,24,10,24,0,0,3,7,8,13,21,1,1,18,4,26,23
Detroit Mercy14,14,Jacob Joubert,,G,Detroit Mercy,Horizon,7,50,1,5,0,2,1,3,0,0,0,0,0,3,1,0,3,6,3
Detroit Mercy15,15,Bass Ollie,FR,G,Detroit Mercy,Horizon,6,24,2,5,1,4,1,1,2,4,0,4,4,2,2,0,1,0,7
Drake1,1,Reed Timmer,SR,G,Drake,MVC,32,1066,180,390,89,178,91,212,173,200,16,96,112,76,18,3,61,53,624
Drake2,2,De'Antae McMurray,,G,Drake,MVC,32,977,114,299,71,167,43,132,56,77,12,120,132,86,35,2,65,67,327
Drake3,3,C.J. Rivers,SR,G,Drake,MVC,32,912,72,133,67,110,5,23,32,50,24,162,186,106,37,5,45,31,181
Drake4,4,Ore Arogundade,SR,G,Drake,MVC,32,808,67,175,36,90,31,85,39,49,29,73,102,45,25,3,35,58,204
Drake5,5,Graham Woodward,SR,G,Drake,MVC,32,761,97,243,36,86,61,157,45,57,11,53,64,50,22,0,42,59,300
Drake6,6,Nick McGlynn,JR,F,Drake,MVC,32,722,144,278,137,258,7,20,59,79,60,117,177,36,12,51,35,99,354
Drake7,7,Casey Schlatter,JR,F,Drake,MVC,32,467,53,112,48,101,5,11,20,31,33,72,105,35,9,9,29,61,131
Drake8,8,Noah Thomas,FR,G,Drake,MVC,32,379,43,110,21,45,22,65,9,14,8,30,38,31,19,2,35,35,117
Drake9,9,Jalen Gibbs,FR,G,Drake,MVC,30,315,36,90,23,46,13,44,12,19,7,39,46,13,10,0,13,8,97
Drake10,10,Kory Kuenstling,JR,F,Drake,MVC,19,102,6,14,6,14,0,0,7,10,6,11,17,3,1,4,8,25,19
Drake11,11,Samm Jones,FR,G,Drake,MVC,5,9,0,1,0,1,0,0,0,0,1,1,2,0,0,0,0,1,0
Drake12,12,Antonio Pilipovic,FR,F,Drake,MVC,5,7,0,3,0,0,0,3,0,0,0,0,0,0,0,0,0,0,0
Drexel1,1,Kurk Lee,SO,G,Drexel,CAA,33,1185,147,382,96,233,51,149,63,83,23,90,113,107,41,2,75,76,408
Drexel2,2,Sammy Mojica,SR,G,Drexel,CAA,33,1174,128,339,66,145,62,194,48,74,44,88,132,48,48,11,47,69,366
Drexel3,3,Tramaine Isabell,JR,G,Drexel,CAA,28,963,202,426,152,279,50,147,132,173,30,180,210,96,34,0,80,52,586
Drexel4,4,Austin Williams,SR,F,Drexel,CAA,31,917,129,216,129,215,0,1,34,74,96,168,264,21,12,92,61,102,292
Drexel5,5,Alihan Demir,SO,F,Drexel,CAA,28,875,119,248,96,185,23,63,39,52,54,98,152,52,12,4,47,63,300
Drexel6,6,Troy Harper,JR,G,Drexel,CAA,25,597,72,188,65,144,7,44,103,126,10,46,56,36,13,2,44,61,254
Drexel7,7,Jarvis Doles,FR,F,Drexel,CAA,23,296,25,58,11,19,14,39,13,16,10,38,48,3,4,1,7,32,77
Drexel8,8,Tyshawn Myles,SR,F,Drexel,CAA,22,237,15,25,15,25,0,0,17,25,28,24,52,2,7,16,14,60,47
Drexel9,9,Tadas Kararinas,FR,F,Drexel,CAA,32,237,17,43,9,22,8,21,9,10,10,16,26,5,2,8,9,33,51
Drexel10,10,Miles Overton,SR,G,Drexel,CAA,10,126,14,48,6,17,8,31,6,6,1,10,11,5,2,1,10,19,42
Drexel11,11,Sam Green,SO,F,Drexel,CAA,6,81,11,20,7,10,4,10,2,6,3,12,15,5,1,0,3,15,28
Drexel12,12,Kevin Doi,,G,Drexel,CAA,7,8,0,0,0,0,0,0,0,0,0,0,0,0,0,0,0,1,0
Drexel13,13,Kris Alford,,G,Drexel,CAA,3,4,1,1,1,1,0,0,1,1,0,0,0,0,0,1,0,0,3
Duke1,1,Grayson Allen,SR,G,Duke,ACC,33,1158,165,385,75,146,90,239,99,116,18,96,114,148,55,2,75,71,519
Duke2,2,Gary Trent Jr.,FR,G,Duke,ACC,33,1103,154,371,69,166,85,205,78,90,26,112,138,47,38,4,36,55,471
Duke3,3,Marvin Bagley III,FR,F,Duke,ACC,29,964,239,395,219,341,20,54,114,184,114,219,333,45,26,29,69,53,612
Duke4,4,Trevon Duval,FR,G,Duke,ACC,33,963,128,302,104,213,24,89,48,83,20,49,69,182,51,5,90,79,328
Duke5,5,Wendell Carter Jr.,FR,F,Duke,ACC,33,895,163,289,144,248,19,41,110,150,101,206,307,68,25,72,67,91,455
Duke6,6,Javin DeLaurier,SO,F,Duke,ACC,29,375,41,65,40,58,1,7,19,32,49,69,118,15,20,19,18,68,102
Duke7,7,Alex O'Connell,,G,Duke,ACC,32,359,42,85,20,41,22,44,14,19,18,30,48,18,9,4,15,15,120
Duke8,8,Marques Bolden,SO,C,Duke,ACC,25,335,44,71,44,71,0,0,13,24,31,61,92,16,8,26,13,35,101
Duke9,9,Jordan Goldwire,FR,G,Duke,ACC,24,163,8,26,4,9,4,17,3,4,3,9,12,24,9,0,7,19,23
Duke10,10,Jack White,SO,F,Duke,ACC,26,150,8,21,6,9,2,12,2,2,10,28,38,5,7,5,6,10,20
Duke11,11,Justin Robinson,SO,F,Duke,ACC,15,77,7,16,1,1,6,15,1,2,0,8,8,2,0,9,4,7,21
Duke12,12,Antonio Vrankovic,JR,C,Duke,ACC,13,64,6,12,6,12,0,0,2,4,5,10,15,7,0,2,4,11,14
Duke13,13,Jordan Tucker,FR,F,Duke,ACC,2,14,2,4,1,2,1,2,1,2,0,1,1,0,0,0,2,0,6
Duke14,14,Mike Buckmire,,G,Duke,ACC,4,5,1,2,1,2,0,0,1,1,0,2,2,1,0,0,0,1,3
Duquesne1,1,Eric Williams Jr.,FR,G,Duquesne,A-10,32,1079,147,375,80,191,67,184,97,131,68,212,280,51,43,10,67,75,458
Duquesne2,2,Rene Castro,SR,G,Duquesne,A-10,32,1022,153,337,105,194,48,143,71,93,20,71,91,108,28,3,56,59,425
Duquesne3,3,Mike Lewis II,SO,G,Duquesne,A-10,32,994,138,359,49,117,89,242,95,115,16,58,74,23,34,1,41,66,460
Duquesne4,4,Tarin Smith,JR,G,Duquesne,A-10,32,912,133,321,94,204,39,117,92,140,17,80,97,102,31,16,69,54,397
Duquesne5,5,Tydus Verhoeven,FR,F,Duquesne,A-10,32,625,40,77,40,77,0,0,20,37,44,62,106,28,7,71,24,94,100
Duquesne6,6,Jordan Robinson,SR,C,Duquesne,A-10,32,596,73,141,73,140,0,1,35,57,48,76,124,21,8,13,20,78,181
Duquesne7,7,Kellon Taylor,SO,F,Duquesne,A-10,29,562,44,71,42,64,2,7,19,30,44,67,111,26,13,7,30,54,109
Duquesne8,8,Chas Brown,,F,Duquesne,A-10,27,454,45,112,43,110,2,2,14,35,55,59,114,14,13,16,44,87,106
Duquesne9,9,Eric James,SR,F,Duquesne,A-10,30,207,19,54,10,19,9,35,8,15,14,26,40,6,8,3,11,17,55
Duquesne10,10,Nicholas Kratholm,FR,F,Duquesne,A-10,9,54,3,13,1,5,2,8,1,6,4,6,10,1,0,0,3,3,9
Duquesne11,11,Marko Krivacevic,,F,Duquesne,A-10,8,30,3,8,1,5,2,3,2,3,3,4,7,0,1,0,2,9,10
Duquesne12,12,Caleb Davis,,G,Duquesne,A-10,4,9,1,3,1,2,0,1,0,0,0,0,0,1,0,0,1,1,2
Duquesne13,13,Zach Snyder,,F,Duquesne,A-10,4,6,2,3,1,1,1,2,0,1,2,2,4,1,0,0,0,1,5
East Carolina1,1,B.J. Tyson,SR,G,East Carolina,AAC,30,1093,162,394,120,250,42,144,82,99,25,105,130,81,24,7,58,60,448
East Carolina2,2,Isaac Fleming,JR,G,East Carolina,AAC,30,962,144,324,121,237,23,87,64,97,39,74,113,144,37,3,107,81,375
East Carolina3,3,Shawn Williams,FR,G,East Carolina,AAC,30,847,117,289,45,93,72,196,65,74,3,46,49,51,14,0,49,44,371
East Carolina4,4,Kentrell Barkley,JR,G,East Carolina,AAC,23,741,103,224,82,151,21,73,49,76,42,120,162,51,30,15,51,50,276
East Carolina5,5,Dimitri Spasojevic,FR,F,East Carolina,AAC,30,717,82,145,82,145,0,0,19,46,41,80,121,20,10,13,47,66,183
East Carolina6,6,Jabari Craig,SR,F,East Carolina,AAC,22,496,45,111,45,110,0,1,28,52,47,86,133,11,4,24,34,66,118
East Carolina7,7,Aaron Jackson,SR,G,East Carolina,AAC,24,353,17,55,10,27,7,28,8,14,16,34,50,8,7,1,19,38,49
East Carolina8,8,K.J. Davis,FR,G,East Carolina,AAC,26,277,30,91,17,38,13,53,7,18,15,44,59,8,9,10,16,23,80
East Carolina9,9,Justin Whatley,FR,F,East Carolina,AAC,22,274,24,53,20,39,4,14,3,6,12,23,35,8,6,4,22,51,55
East Carolina10,10,Usman Haruna,JR,F,East Carolina,AAC,24,230,11,21,11,21,0,0,1,8,13,42,55,2,4,7,8,41,23
East Carolina11,11,Justice Obasohan,JR,G,East Carolina,AAC,8,71,5,14,5,13,0,1,3,4,1,8,9,2,3,9,5,9,13
East Carolina12,12,Addison Hill,JR,G,East Carolina,AAC,6,7,0,1,0,1,0,0,0,0,0,3,3,1,0,0,0,1,0
East Carolina13,13,John Whitley,SO,G,East Carolina,AAC,3,7,1,1,1,1,0,0,0,0,0,1,1,1,0,0,0,0,2
East Tennessee State1,1,Desonta Bradford,SR,G,East Tennessee State,Southern,33,1075,180,380,138,245,42,135,105,142,26,165,191,116,62,15,72,64,507
East Tennessee State2,2,Jalan McCloud,SR,G,East Tennessee State,Southern,33,869,144,297,113,217,31,80,71,96,15,80,95,114,37,7,79,67,390
East Tennessee State3,3,Devontavius Payne,SR,G,East Tennessee State,Southern,33,775,107,262,37,83,70,179,24,30,16,88,104,36,30,16,31,62,308
East Tennessee State4,4,David Burrell,SR,F,East Tennessee State,Southern,33,718,90,186,72,120,18,66,32,53,48,112,160,30,16,20,43,58,230
East Tennessee State5,5,Jermaine Long,SR,G,East Tennessee State,Southern,34,698,39,117,20,40,19,77,27,33,8,67,75,87,34,4,55,89,124
East Tennessee State6,6,Bo Hodges,FR,G,East Tennessee State,Southern,32,679,109,213,103,188,6,25,65,98,36,75,111,29,26,22,32,59,289
East Tennessee State7,7,Mladen Armus,FR,F,East Tennessee State,Southern,34,617,84,134,84,133,0,1,45,73,86,101,187,17,19,15,46,68,213
East Tennessee State8,8,Peter Jurkin,SR,C,East Tennessee State,Southern,33,569,89,157,82,140,7,17,62,74,40,114,154,6,15,36,35,63,247
East Tennessee State9,9,Jason Williams,SO,G,East Tennessee State,Southern,32,347,30,67,6,17,24,50,5,11,7,16,23,42,12,2,31,27,89
East Tennessee State10,10,Kanayo Obi-Rapu,JR,G,East Tennessee State,Southern,28,279,27,82,6,18,21,64,19,22,8,26,34,15,7,2,8,30,94
East Tennessee State11,11,James Harrison,JR,F,East Tennessee State,Southern,15,80,12,25,12,25,0,0,2,9,5,14,19,2,1,4,7,16,26
East Tennessee State12,12,Andre Edwards,JR,G,East Tennessee State,Southern,4,60,12,28,8,16,4,12,1,2,4,7,11,3,5,3,2,4,29
East Tennessee State13,13,Dillon Reppart,SR,G,East Tennessee State,Southern,8,31,2,8,0,3,2,5,2,5,5,2,7,3,1,0,1,6,8
East Tennessee State14,14,Karl Overstreet,,C,East Tennessee State,Southern,2,3,1,1,1,1,0,0,0,0,0,0,0,0,0,0,0,0,2
Eastern Illinois1,1,Montell Goodwin,SR,G,Eastern Illinois,OVC,31,1100,164,411,91,208,73,203,64,83,15,89,104,103,34,12,61,46,465
Eastern Illinois2,2,Ray Crossland,SR,C,Eastern Illinois,OVC,31,916,84,223,56,141,28,82,46,73,59,86,145,39,31,11,59,79,242
Eastern Illinois3,3,Muusa Dama,SR,F,Eastern Illinois,OVC,31,759,124,227,123,224,1,3,58,82,64,131,195,36,15,36,59,99,307
Eastern Illinois4,4,Mack Smith,FR,G,Eastern Illinois,OVC,25,682,106,231,52,92,54,139,44,59,5,91,96,35,17,5,41,55,310
Eastern Illinois5,5,Jajuan Starks,JR,C,Eastern Illinois,OVC,31,665,102,244,88,194,14,50,52,85,53,72,125,26,16,14,52,46,270
Eastern Illinois6,6,Aboubacar Diallo,JR,F,Eastern Illinois,OVC,31,403,12,29,12,29,0,0,8,11,29,64,93,16,5,47,10,55,32
Eastern Illinois7,7,D'Angelo Jackson,,G,Eastern Illinois,OVC,17,339,35,94,30,84,5,10,54,82,20,35,55,37,14,1,52,32,129
Eastern Illinois8,8,Lucas Jones,JR,F,Eastern Illinois,OVC,26,325,15,37,8,17,7,20,11,14,12,39,51,18,5,7,9,15,48
Eastern Illinois9,9,Terrell Lewis,SR,G,Eastern Illinois,OVC,8,283,23,63,5,16,18,47,8,12,5,14,19,38,15,0,15,19,72
Eastern Illinois10,10,Logan Koch,,G,Eastern Illinois,OVC,13,227,10,35,2,5,8,30,2,2,0,13,13,14,8,0,11,21,30
Eastern Illinois11,11,DeVantae Price,,G,Eastern Illinois,OVC,20,187,17,41,16,38,1,3,22,32,18,23,41,8,7,0,14,18,57
Eastern Illinois12,12,Justice Green,JR,C,Eastern Illinois,OVC,21,137,20,48,11,18,9,30,4,8,1,17,18,5,9,2,3,9,53
Eastern Illinois13,13,Michael Chavers,JR,C,Eastern Illinois,OVC,14,136,17,37,11,28,6,9,3,5,10,21,31,8,4,3,4,7,43
Eastern Illinois14,14,Shawn Wilson,SO,G,Eastern Illinois,OVC,9,66,3,6,3,5,0,1,1,3,1,1,2,9,2,0,8,8,7
Eastern Kentucky1,1,Nick Mayo,JR,F,Eastern Kentucky,OVC,31,1062,202,384,169,310,33,74,120,143,47,161,208,67,24,46,98,88,557
Eastern Kentucky2,2,DeAndre Dishman,SO,F,Eastern Kentucky,OVC,30,820,130,229,130,228,0,1,92,145,66,120,186,32,28,23,51,71,352
Eastern Kentucky3,3,Dedric Boyd,FR,G,Eastern Kentucky,OVC,24,651,103,293,69,172,34,121,75,90,14,65,79,48,22,2,60,48,315
Eastern Kentucky4,4,Zach Charles,SR,F,Eastern Kentucky,OVC,30,602,63,119,55,104,8,15,44,66,49,91,140,23,14,29,25,65,178
Eastern Kentucky5,5,Dujuanta Weaver,,G,Eastern Kentucky,OVC,21,565,45,130,9,30,36,100,13,15,11,40,51,52,22,2,35,49,139
Eastern Kentucky6,6,Dillon Avare,SR,G,Eastern Kentucky,OVC,30,560,47,121,1,1,46,120,2,2,5,17,22,29,9,1,20,33,142
Eastern Kentucky7,7,Jacquess Hobbs,FR,G,Eastern Kentucky,OVC,23,549,44,138,32,89,12,49,29,39,13,52,65,83,32,0,33,54,129
Eastern Kentucky8,8,Peyton Broughton,FR,G,Eastern Kentucky,OVC,28,447,38,96,23,57,15,39,24,29,16,26,42,22,10,2,15,32,115
Eastern Kentucky9,9,A.J. Youngman,FR,G,Eastern Kentucky,OVC,28,403,36,95,6,19,30,76,3,4,4,33,37,16,10,2,13,39,105
Eastern Kentucky10,10,Jackson Davis,JR,F,Eastern Kentucky,OVC,16,288,48,105,44,87,4,18,31,40,23,52,75,7,18,6,22,35,131
Eastern Kentucky11,11,Asante Gist,SO,G,Eastern Kentucky,OVC,6,165,17,55,10,37,7,18,7,15,1,17,18,16,3,0,11,16,48
Eastern Kentucky12,12,Cameron Carmical,FR,G,Eastern Kentucky,OVC,14,63,0,6,0,1,0,5,1,2,0,4,4,8,1,0,5,8,1
Eastern Kentucky13,13,Lachlan Anderson,SO,F,Eastern Kentucky,OVC,13,40,5,6,4,5,1,1,7,10,1,11,12,2,0,0,3,3,18
Eastern Kentucky14,14,Kirkland Humphrey,JR,G,Eastern Kentucky,OVC,7,10,0,2,0,1,0,1,0,0,0,3,3,0,0,0,0,1,0
Eastern Michigan1,1,Paul Jackson,JR,G,Eastern Michigan,MAC,33,1157,185,442,154,341,31,101,102,136,11,56,67,150,44,2,95,79,503
Eastern Michigan2,2,James Thompson IV,JR,F,Eastern Michigan,MAC,33,1123,191,280,191,280,0,0,104,167,131,233,364,10,26,60,62,109,486
Eastern Michigan3,3,Elijah Minnie,JR,F,Eastern Michigan,MAC,33,1042,196,435,125,222,71,213,91,108,46,159,205,39,61,60,77,66,554
Eastern Michigan4,4,Tim Bond,SR,G,Eastern Michigan,MAC,33,1029,118,253,89,172,29,81,43,64,28,124,152,110,82,37,60,70,308
Eastern Michigan5,5,Jordan Nobles,JR,F,Eastern Michigan,MAC,33,756,54,128,21,39,33,89,6,9,16,66,82,26,23,13,19,61,147
Eastern Michigan6,6,Ty Groce,SO,F,Eastern Michigan,MAC,32,480,43,111,29,67,14,44,24,39,20,60,80,20,21,16,32,61,124
Eastern Michigan7,7,Malik Ellison,FR,G,Eastern Michigan,MAC,31,407,21,76,12,38,9,38,11,20,7,15,22,44,18,0,29,18,62
Eastern Michigan8,8,Kevin McAdoo,FR,G,Eastern Michigan,MAC,26,263,36,78,19,35,17,43,13,17,3,13,16,14,4,2,16,13,102
Eastern Michigan9,9,Terry Harris,JR,G,Eastern Michigan,MAC,15,161,14,40,5,13,9,27,4,8,4,10,14,6,3,1,5,6,41
Eastern Michigan10,10,Bud Jones,FR,F,Eastern Michigan,MAC,23,91,10,14,10,14,0,0,3,8,11,12,23,1,0,3,7,22,23
Eastern Michigan11,11,Jalen King,FR,F,Eastern Michigan,MAC,19,84,0,3,0,3,0,0,0,2,3,11,14,0,3,8,6,21,0
Eastern Michigan12,12,Isaiah Green,JR,F,Eastern Michigan,MAC,15,82,6,12,6,11,0,1,2,3,3,17,20,0,5,5,2,6,14
Eastern Washington1,1,Bogdan Bliznyuk,SR,G,Eastern Washington,Big Sky,34,1192,254,481,210,372,44,109,162,180,32,199,231,134,27,10,113,80,714
Eastern Washington2,2,Jack Perry,FR,G,Eastern Washington,Big Sky,34,931,81,176,25,50,56,126,17,21,8,61,69,84,13,0,51,46,235
Eastern Washington3,3,Ty Gibson,JR,G,Eastern Washington,Big Sky,34,889,69,177,10,18,59,159,15,20,11,64,75,42,22,1,23,48,212
Eastern Washington4,4,Sir Washington,SR,G,Eastern Washington,Big Sky,33,758,73,194,53,125,20,69,45,73,16,80,96,53,23,4,38,73,211
Eastern Washington5,5,Cody Benzel,JR,G,Eastern Washington,Big Sky,33,665,68,168,2,15,66,153,16,17,4,33,37,17,19,4,12,45,218
Eastern Washington6,6,Mason Peatling,SO,F,Eastern Washington,Big Sky,30,628,93,176,88,155,5,21,43,69,62,108,170,18,27,34,27,99,234
Eastern Washington7,7,Jacob Davison,FR,G,Eastern Washington,Big Sky,33,518,75,153,48,89,27,64,60,71,21,70,91,19,22,11,32,55,237
Eastern Washington8,8,Benas Griciunas,SR,C,Eastern Washington,Big Sky,33,443,76,160,73,137,3,23,18,34,20,80,100,11,6,23,19,63,173
Eastern Washington9,9,Jesse Hunt,JR,F,Eastern Washington,Big Sky,20,366,55,111,41,73,14,38,25,31,32,79,111,21,6,9,24,59,149
Eastern Washington10,10,Richard Polanco,FR,F,Eastern Washington,Big Sky,26,221,38,81,29,53,9,28,18,25,9,33,42,10,5,5,28,58,103
Eastern Washington11,11,Luka Vulikic,SO,G,Eastern Washington,Big Sky,9,206,25,55,25,50,0,5,7,15,7,22,29,20,6,2,14,16,57
Eastern Washington12,12,Grant Gibb,SO,G,Eastern Washington,Big Sky,11,22,2,8,1,5,1,3,1,2,1,5,6,2,0,0,0,3,6
Eastern Washington13,13,Joshua Thomas,FR,G,Eastern Washington,Big Sky,7,11,2,7,1,4,1,3,0,0,2,1,3,0,0,0,3,2,5
Elon1,1,Tyler Seibring,JR,F,Elon,CAA,32,1090,183,373,101,182,82,191,46,65,48,168,216,70,9,21,35,49,494
Elon2,2,Dainan Swoope,JR,G,Elon,CAA,32,1065,116,338,52,126,64,212,89,108,9,90,99,126,32,8,70,72,385
Elon3,3,Dmitri Thompson,SR,G,Elon,CAA,32,1014,133,293,84,165,49,128,77,102,37,134,171,72,22,6,50,53,392
Elon4,4,Steve Santa Ana,,G,Elon,CAA,32,906,108,251,55,104,53,147,40,62,24,117,141,62,25,8,58,67,309
Elon5,5,Brian Dawkins,SR,F,Elon,CAA,29,821,142,288,104,171,38,117,31,51,32,125,157,34,11,8,36,73,353
Elon6,6,Sheldon Eberhardt,JR,G,Elon,CAA,31,588,62,130,50,79,12,51,20,33,16,73,89,79,12,7,39,55,156
Elon7,7,Karolis Kundrotas,JR,C,Elon,CAA,31,325,32,63,27,48,5,15,9,13,21,37,58,11,7,6,18,41,78
Elon8,8,Seth Fuller,FR,G,Elon,CAA,31,310,26,82,6,19,20,63,8,11,6,27,33,26,11,0,29,27,80
Elon9,9,Simon Wright,FR,F,Elon,CAA,32,287,22,63,12,34,10,29,1,2,15,33,48,18,7,2,17,36,55
Elon10,10,Collin Luther,SR,C,Elon,CAA,15,77,3,8,3,4,0,4,0,3,5,10,15,6,3,0,2,11,6
Elon11,11,Jack Anton,SR,F,Elon,CAA,11,54,4,7,3,4,1,3,4,7,3,6,9,1,0,0,0,5,13
Elon12,12,Nathan Priddy,,G,Elon,CAA,7,33,5,10,2,5,3,5,0,0,1,0,1,2,0,0,5,5,13
Elon13,13,Duje Radja,FR,C,Elon,CAA,6,21,4,7,4,6,0,1,0,0,1,3,4,0,1,0,0,0,8
Elon14,14,Jack George,SR,F,Elon,CAA,4,7,2,2,2,2,0,0,0,0,1,1,2,0,0,0,0,0,4
Elon15,15,Maxwell Chester,SO,G,Elon,CAA,2,2,0,1,0,1,0,0,0,0,0,0,0,0,0,0,0,0,0
Evansville1,1,Blake Simmons,SR,G,Evansville,MVC,31,1108,117,267,69,149,48,118,41,53,18,127,145,65,28,9,61,61,323
Evansville2,2,Ryan Taylor,,G,Evansville,MVC,25,879,194,458,127,299,67,159,76,88,12,84,96,28,20,6,57,57,531
Evansville3,3,K.J. Riley,SO,G,Evansville,MVC,32,767,54,131,53,122,1,9,109,141,18,92,110,86,33,5,64,73,218
Evansville4,4,Noah Frederking,FR,G,Evansville,MVC,32,690,57,149,33,83,24,66,35,43,13,43,56,36,12,3,30,28,173
Evansville5,5,Dru Smith,SO,G,Evansville,MVC,22,665,100,173,73,117,27,56,75,88,10,67,77,101,45,10,70,60,302
Evansville6,6,Dainius Chatkevicius,JR,F,Evansville,MVC,32,607,66,116,66,116,0,0,22,41,50,122,172,5,8,39,33,77,154
Evansville7,7,Duane Gibson,SR,G,Evansville,MVC,20,446,52,119,52,119,0,0,26,38,8,50,58,53,22,7,45,52,130
Evansville8,8,John Hall,FR,F,Evansville,MVC,32,439,37,104,36,98,1,6,16,22,24,62,86,15,7,7,20,58,91
Evansville9,9,Dalen Traore,SR,C,Evansville,MVC,30,371,17,47,17,46,0,1,34,45,29,52,81,5,5,3,14,57,68
Evansville10,10,Evan Kuhlman,FR,F,Evansville,MVC,25,284,22,48,12,26,10,22,5,6,5,24,29,5,5,3,6,31,59
Evansville11,11,Marty Hill,JR,G,Evansville,MVC,9,127,13,36,7,25,6,11,1,2,8,15,23,8,3,0,7,7,33
Evansville12,12,Solomon Hainna,SR,F,Evansville,MVC,3,42,1,4,1,3,0,1,10,14,2,3,5,2,2,0,2,7,12
Fairfield1,1,Tyler Nelson,SR,G,Fairfield,MAAC,33,1205,230,547,126,252,104,295,168,191,18,120,138,110,45,3,82,55,732
Fairfield2,2,Ferron Flavors Jr.,SO,G,Fairfield,MAAC,33,1033,134,378,39,95,95,283,43,58,18,102,120,36,20,0,27,64,406
Fairfield3,3,Jesus Cruz,FR,G,Fairfield,MAAC,33,893,119,276,92,180,27,96,35,63,30,115,145,45,53,6,48,94,300
Fairfield4,4,Jonathan Kasibabu,JR,F,Fairfield,MAAC,32,681,104,154,95,132,9,22,72,107,58,120,178,37,13,35,53,107,289
Fairfield5,5,Aidas Kavaliauskas,,G,Fairfield,MAAC,20,602,42,90,27,51,15,39,8,12,5,50,55,92,27,1,44,41,107
Fairfield6,6,Jerome Segura,SR,G,Fairfield,MAAC,30,588,49,127,37,97,12,30,16,23,5,28,33,71,19,0,33,45,126
Fairfield7,7,Matija Milin,JR,F,Fairfield,MAAC,26,442,63,130,49,85,14,45,17,29,34,74,108,28,9,2,25,47,157
Fairfield8,8,Wassef Methnani,FR,F,Fairfield,MAAC,30,414,75,156,59,111,16,45,27,38,41,67,108,25,11,25,47,88,193
Fairfield9,9,Kevin Senghore-Peterson,FR,F,Fairfield,MAAC,24,354,26,58,20,41,6,17,16,34,24,46,70,11,1,9,15,40,74
Fairfield10,10,Taj Benning,FR,G,Fairfield,MAAC,25,255,10,31,5,18,5,13,15,20,8,26,34,20,3,5,16,34,40
Fairfield11,11,Omar El-Sheikh,,F,Fairfield,MAAC,23,239,29,57,29,53,0,4,21,42,17,46,63,11,10,9,25,46,79
Fairfield12,12,Thomas Nolan,JR,G,Fairfield,MAAC,8,10,0,4,0,1,0,3,1,2,0,0,0,0,0,0,0,1,1
Fairfield13,13,Jared Harper,,G,Fairfield,MAAC,4,6,0,0,0,0,0,0,0,0,1,0,1,1,0,0,1,1,0
Fairfield14,14,Olivier Cadieux,,G,Fairfield,MAAC,2,3,0,1,0,0,0,1,2,2,0,1,1,0,0,0,0,0,2
Fairleigh Dickinson1,1,Jahlil Jenkins,FR,G,Fairleigh Dickinson,NEC,31,1049,134,308,100,198,34,110,69,101,10,73,83,136,38,1,72,47,371
Fairleigh Dickinson2,2,Darnell Edge,JR,G,Fairleigh Dickinson,NEC,30,1021,146,325,86,159,60,166,84,89,13,74,87,71,40,1,48,53,436
Fairleigh Dickinson3,3,Mike Holloway,JR,F,Fairleigh Dickinson,NEC,31,922,159,329,152,306,7,23,91,132,80,137,217,38,21,21,74,108,416
Fairleigh Dickinson4,4,Noah Morgan,FR,F,Fairleigh Dickinson,NEC,30,838,117,246,69,136,48,110,48,58,39,108,147,41,24,21,61,83,330
Fairleigh Dickinson5,5,Kaleb Bishop,SO,F,Fairleigh Dickinson,NEC,30,701,107,208,99,187,8,21,43,62,68,122,190,18,11,15,41,88,265
Fairleigh Dickinson6,6,Elyjah Williams,FR,F,Fairleigh Dickinson,NEC,30,453,51,79,49,76,2,3,17,33,48,65,113,27,23,18,37,59,121
Fairleigh Dickinson7,7,Darian Anderson,SR,G,Fairleigh Dickinson,NEC,15,433,72,207,42,113,30,94,38,50,9,45,54,51,32,4,29,38,212
Fairleigh Dickinson8,8,Pat McNamara,SO,G,Fairleigh Dickinson,NEC,29,326,21,60,6,13,15,47,4,8,6,19,25,15,12,2,13,13,61
Fairleigh Dickinson9,9,Nadi Beciri,JR,F,Fairleigh Dickinson,NEC,27,156,16,39,15,32,1,7,8,16,19,26,45,7,7,8,13,29,41
Fairleigh Dickinson10,10,Tyler Jones,FR,G,Fairleigh Dickinson,NEC,18,83,3,19,1,4,2,15,3,4,2,3,5,3,5,0,1,13,11
Fairleigh Dickinson11,11,Mike Schroback,SR,G,Fairleigh Dickinson,NEC,23,80,6,19,2,5,4,14,5,6,0,4,4,7,2,0,9,3,21
Fairleigh Dickinson12,12,Malik Miller,JR,C,Fairleigh Dickinson,NEC,16,72,4,20,2,8,2,12,3,4,2,13,15,1,3,6,6,18,13
Fairleigh Dickinson13,13,Dondre Rhoden,JR,F,Fairleigh Dickinson,NEC,15,57,5,7,5,7,0,0,3,10,3,7,10,1,1,3,2,9,13
Fairleigh Dickinson14,14,Brian Fabre,,G,Fairleigh Dickinson,NEC,6,9,1,2,1,1,0,1,0,0,0,1,1,0,1,0,2,0,2
Florida1,1,Chris Chiozza,SR,G,Florida,SEC,32,1030,124,293,87,190,37,103,72,90,17,125,142,194,59,3,60,67,357
Florida2,2,KeVaughn Allen,JR,G,Florida,SEC,32,999,114,310,57,140,57,170,73,81,15,61,76,74,31,14,37,45,358
Florida3,3,Egor Koulechov,SR,G,Florida,SEC,32,980,148,359,84,201,64,158,76,87,56,152,208,40,20,4,41,70,436
Florida4,4,Jalen Hudson,JR,G,Florida,SEC,32,843,165,364,91,183,74,181,85,127,11,114,125,33,25,18,38,67,489
Florida5,5,Keith Stone,SO,F,Florida,SEC,32,766,94,212,57,126,37,86,61,84,47,82,129,23,20,25,45,85,286
Florida6,6,Kevarrius Hayes,JR,F,Florida,SEC,31,737,59,103,59,103,0,0,34,68,74,85,159,12,29,64,33,76,152
Florida7,7,Mike Okauru,FR,G,Florida,SEC,32,344,44,96,26,50,18,46,15,28,5,25,30,20,17,2,10,31,121
Florida8,8,Deaundrae Ballard,FR,G,Florida,SEC,28,307,42,111,37,79,5,32,18,24,16,35,51,9,7,1,14,32,107
Florida9,9,Gorjok Gak,SO,C,Florida,SEC,27,246,26,41,26,41,0,0,10,26,29,35,64,3,2,11,11,36,62
Florida10,10,Dontay Bassett,FR,F,Florida,SEC,23,161,15,28,15,28,0,0,9,14,20,14,34,4,7,7,4,38,39
Florida11,11,Chase Johnson,FR,F,Florida,SEC,4,33,6,12,6,12,0,0,5,6,5,3,8,1,2,2,1,2,17
Florida12,12,Mak Krause,,G,Florida,SEC,6,15,1,2,1,2,0,0,2,5,1,0,1,0,0,0,0,2,4
Florida13,13,Andrew Fava,,G,Florida,SEC,6,13,3,6,3,4,0,2,0,0,0,1,1,2,0,0,2,1,6
Florida A&M1,1,Desmond Williams,,F,Florida A&M,MEAC,34,1214,221,504,210,463,11,41,164,222,60,148,208,64,40,25,100,78,617
Florida A&M2,2,Marcus Barham,,G,Florida A&M,MEAC,31,1115,169,431,84,197,85,234,103,123,32,101,133,59,25,6,92,60,526
Florida A&M3,3,Elijah Mayes,,G,Florida A&M,MEAC,30,885,130,270,100,203,30,67,44,51,8,55,63,85,27,0,53,78,334
Florida A&M4,4,Justin Ravenel,,G,Florida A&M,MEAC,34,873,99,240,36,80,63,160,32,40,11,61,72,33,20,2,14,59,293
Florida A&M5,5,Nick Severado,,F,Florida A&M,MEAC,32,765,46,109,46,108,0,1,29,45,47,90,137,14,17,23,32,98,121
Florida A&M6,6,Nasir Core,,G,Florida A&M,MEAC,34,510,48,129,33,80,15,49,41,67,19,61,80,42,23,4,48,69,152
Florida A&M7,7,Isaiah Martin,,C,Florida A&M,MEAC,17,462,59,99,59,99,0,0,20,36,48,62,110,7,7,36,19,36,138
Florida A&M8,8,Brendon Myles,,G,Florida A&M,MEAC,34,400,17,56,17,52,0,4,7,11,19,42,61,9,13,5,33,36,41
Florida A&M9,9,Kamron Reaves,,G,Florida A&M,MEAC,13,237,15,55,9,27,6,28,10,16,6,20,26,20,3,0,31,31,46
Florida A&M10,10,Craig Bowman,,G,Florida A&M,MEAC,22,212,17,56,11,27,6,29,6,15,2,23,25,25,11,0,20,23,46
Florida A&M11,11,Javonni Harrell,,F,Florida A&M,MEAC,13,99,5,17,5,16,0,1,2,6,10,11,21,6,5,1,3,14,12
Florida A&M12,12,Rashad Austin,,F,Florida A&M,MEAC,20,89,1,4,1,4,0,0,1,3,5,4,9,2,1,2,3,21,3
Florida A&M13,13,Bryce Moragne,,G,Florida A&M,MEAC,18,64,4,11,3,9,1,2,5,6,5,3,8,4,2,0,2,9,14
Florida Atlantic1,1,Ronald Delph,SR,C,Florida Atlantic,CUSA,31,910,200,404,200,402,0,2,53,76,84,186,270,23,13,63,52,82,453
Florida Atlantic2,2,Gerdarius Troutman,SR,G,Florida Atlantic,CUSA,31,841,122,292,47,111,75,181,63,72,14,64,78,35,27,4,23,25,382
Florida Atlantic3,3,William Pfister,SR,F,Florida Atlantic,CUSA,31,794,41,82,41,82,0,0,14,22,76,139,215,31,22,12,38,106,96
Florida Atlantic4,4,Justin Massey,SR,G,Florida Atlantic,CUSA,31,791,129,361,55,138,74,223,94,120,14,54,68,45,15,0,34,57,426
Florida Atlantic5,5,Jailyn Ingram,SO,F,Florida Atlantic,CUSA,30,787,105,259,97,228,8,31,49,71,37,92,129,46,17,9,74,76,267
Florida Atlantic6,6,Payton Hulsey,SR,G,Florida Atlantic,CUSA,28,723,63,178,56,152,7,26,51,76,29,98,127,96,42,1,72,70,184
Florida Atlantic7,7,Anthony Adger,JR,G,Florida Atlantic,CUSA,31,623,66,198,60,145,6,53,50,61,8,51,59,72,19,0,53,43,188
Florida Atlantic8,8,Amir Smith,JR,F,Florida Atlantic,CUSA,28,253,29,58,29,58,0,0,4,11,27,46,73,2,6,33,8,30,62
Florida Atlantic9,9,Devorious Brown,SO,G,Florida Atlantic,CUSA,24,244,13,43,13,37,0,6,14,19,9,19,28,20,13,0,20,27,40
Florida Atlantic10,10,Je'Quan Perry,,G,Florida Atlantic,CUSA,12,113,8,26,2,9,6,17,2,3,1,21,22,4,5,0,5,15,24
Florida Atlantic11,11,Simeon Lepichev,JR,C,Florida Atlantic,CUSA,16,106,11,21,8,12,3,9,1,3,5,17,22,2,3,2,7,20,26
Florida Atlantic12,12,Tre' Maloney,,F,Florida Atlantic,CUSA,6,21,2,3,2,3,0,0,0,0,0,2,2,0,0,0,1,2,4
Florida Atlantic13,13,Byron Abrams,FR,G,Florida Atlantic,CUSA,3,9,0,2,0,0,0,2,0,0,1,0,1,0,0,0,0,0,0
Florida Atlantic14,14,Chisom Obidike,FR,C,Florida Atlantic,CUSA,4,9,1,1,1,1,0,0,1,3,0,1,1,0,0,0,1,3,3
Florida Gulf Coast1,1,Zach Johnson,JR,G,Florida Gulf Coast,A-Sun,34,1100,196,414,130,246,66,168,83,106,15,96,111,102,68,5,75,68,541
Florida Gulf Coast2,2,Brandon Goodwin,SR,G,Florida Gulf Coast,A-Sun,33,1098,216,454,175,308,41,146,141,188,38,144,182,157,45,4,98,49,614
Florida Gulf Coast3,3,Christian Terrell,SR,G,Florida Gulf Coast,A-Sun,34,995,151,291,99,161,52,130,54,66,31,138,169,102,28,10,77,45,408
Florida Gulf Coast4,4,Dinero Mercurius,JR,G,Florida Gulf Coast,A-Sun,31,684,78,185,22,48,56,137,36,39,18,37,55,21,21,3,29,57,248
Florida Gulf Coast5,5,Antravious Simmons,SR,F,Florida Gulf Coast,A-Sun,32,555,93,161,93,161,0,0,42,62,61,100,161,33,14,4,31,78,228
Florida Gulf Coast6,6,Christian Carlyle,SO,G,Florida Gulf Coast,A-Sun,26,502,48,110,39,91,9,19,34,41,26,38,64,31,21,4,30,64,139
Florida Gulf Coast7,7,Michael Gilmore,,F,Florida Gulf Coast,A-Sun,23,423,60,124,48,90,12,34,19,30,26,102,128,21,11,17,38,74,151
Florida Gulf Coast8,8,RaySean Scott Jr.,SO,F,Florida Gulf Coast,A-Sun,25,388,69,103,67,93,2,10,29,38,41,74,115,16,8,13,17,64,169
Florida Gulf Coast9,9,Ricky Doyle,JR,F,Florida Gulf Coast,A-Sun,25,385,53,94,53,92,0,2,22,35,26,60,86,21,11,20,29,55,128
Florida Gulf Coast10,10,Brady Ernst,SO,F,Florida Gulf Coast,A-Sun,32,320,28,42,28,42,0,0,12,29,16,55,71,10,9,9,14,40,68
Florida Gulf Coast11,11,Brian Thomas,FR,F,Florida Gulf Coast,A-Sun,17,144,18,28,18,28,0,0,14,18,17,30,47,1,2,6,10,15,50
Florida Gulf Coast12,12,Darnell Rogers,FR,G,Florida Gulf Coast,A-Sun,19,125,6,24,2,8,4,16,2,4,2,3,5,8,5,0,12,9,18
Florida Gulf Coast13,13,Dolan Mahoney,JR,G,Florida Gulf Coast,A-Sun,13,29,2,4,2,3,0,1,0,0,2,1,3,1,1,0,1,4,4
Florida Gulf Coast14,14,Joshua Ko,SR,G,Florida Gulf Coast,A-Sun,12,27,3,16,1,9,2,7,0,0,1,6,7,0,2,0,2,0,8
Florida Gulf Coast15,15,Ryan McAdoo,FR,G,Florida Gulf Coast,A-Sun,14,25,1,7,1,5,0,2,3,6,0,3,3,0,2,0,3,0,5
Florida International1,1,Eric Lockett,JR,G,Florida International,CUSA,32,1185,180,388,166,340,14,48,81,113,41,168,209,98,39,12,66,76,455
Florida International2,2,Brian Beard Jr.,JR,G,Florida International,CUSA,31,1114,167,411,131,265,36,146,138,213,6,114,120,171,90,0,100,77,508
Florida International3,3,Trejon Jacob,SO,G,Florida International,CUSA,31,1043,159,368,87,176,72,192,63,98,26,128,154,44,35,8,37,51,453
Florida International4,4,Michael Douglas,JR,F,Florida International,CUSA,31,678,64,172,33,87,31,85,37,57,28,76,104,10,23,4,18,67,196
Florida International5,5,Hassan Hussein,JR,F,Florida International,CUSA,31,559,71,162,70,156,1,6,29,38,31,69,100,11,9,13,34,62,172
Florida International6,6,Jay Harvey,JR,F,Florida International,CUSA,30,481,20,44,20,44,0,0,15,41,56,36,92,3,5,8,21,65,55
Florida International7,7,Osasumwen Osaghae,SO,F,Florida International,CUSA,27,321,32,51,32,51,0,0,25,46,30,60,90,1,7,33,13,53,89
Florida International8,8,Josh Stamps,JR,G,Florida International,CUSA,12,235,35,93,18,40,17,53,14,21,6,16,22,8,7,1,11,20,101
Florida International9,9,Cordell Veira,,G,Florida International,CUSA,30,225,11,41,5,23,6,18,5,16,4,26,30,24,6,2,10,18,33
Florida International10,10,Elhadji Dieng,JR,C,Florida International,CUSA,22,212,10,26,10,26,0,0,7,27,19,27,46,1,3,11,7,42,27
Florida International11,11,Isaiah Banks,FR,G,Florida International,CUSA,21,170,19,41,14,23,5,18,7,13,9,17,26,6,9,3,9,16,50
Florida International12,12,Willy Nunez Jr.,JR,G,Florida International,CUSA,7,160,28,72,13,28,15,44,5,14,5,10,15,5,3,1,5,10,76
Florida International13,13,Ronald Whitaker,SR,F,Florida International,CUSA,14,111,14,27,13,21,1,6,1,4,9,13,22,4,3,3,7,20,30
Florida International14,14,Kasper Christensen,,F,Florida International,CUSA,10,56,5,17,0,1,5,16,2,3,0,6,6,1,3,3,1,8,17
Florida State1,1,Phil Cofer,SR,F,Florida State,ACC,31,908,154,314,109,200,45,114,54,81,51,107,158,23,15,6,35,42,407
Florida State2,2,Terance Mann,JR,G,Florida State,ACC,30,885,157,280,145,231,12,49,69,103,63,107,170,80,28,8,53,49,395
Florida State3,3,Braian Angola-Rodas,SR,G,Florida State,ACC,31,851,125,296,67,138,58,158,91,109,28,91,119,92,42,6,65,76,399
Florida State4,4,Trent Forrest,SO,G,Florida State,ACC,30,762,76,149,73,136,3,13,76,108,39,107,146,119,43,10,53,48,231
Florida State5,5,CJ Walker,SO,G,Florida State,ACC,31,743,88,210,52,107,36,103,50,69,6,78,84,82,32,4,52,77,262
Florida State6,6,M.J. Walker,FR,G,Florida State,ACC,31,604,78,196,37,85,41,111,39,50,6,46,52,34,17,4,38,72,236
Florida State7,7,Mfiondu Kabengele,FR,F,Florida State,ACC,30,424,75,150,66,126,9,24,53,83,57,78,135,10,14,21,30,63,212
Florida State8,8,Chris Koumadje,JR,C,Florida State,ACC,20,347,64,99,64,99,0,0,19,34,38,56,94,3,0,32,18,50,147
Florida State9,9,Ike Obiagu,FR,C,Florida State,ACC,30,336,29,53,29,53,0,0,12,38,30,49,79,2,7,67,24,53,70
Florida State10,10,PJ Savoy,JR,G,Florida State,ACC,23,279,46,127,7,19,39,108,10,15,5,25,30,15,5,0,14,21,141
Florida State11,11,Brandon Allen,SR,F,Florida State,ACC,21,89,9,19,6,7,3,12,0,0,2,6,8,6,3,0,9,11,21
Florida State12,12,Wyatt Wilkes,FR,F,Florida State,ACC,6,44,2,9,2,2,0,7,0,1,2,7,9,3,1,2,5,2,4
Florida State13,13,Justin Lindner,SO,G,Florida State,ACC,3,7,0,1,0,1,0,0,0,0,0,1,1,2,0,0,2,1,0
Florida State14,14,Will Miles,FR,F,Florida State,ACC,3,6,0,2,0,0,0,2,0,0,0,1,1,0,0,0,0,1,0
Florida State15,15,Travis Light,FR,G,Florida State,ACC,3,6,2,5,0,0,2,5,0,0,0,1,1,0,0,0,0,0,6
Florida State16,16,Harrison Prieto,SO,F,Florida State,ACC,2,5,1,2,1,2,0,0,0,0,0,0,0,1,0,0,0,0,2
Florida State17,17,Anthony Polite,FR,G,Florida State,ACC,1,4,0,0,0,0,0,0,0,0,0,1,1,1,1,0,1,0,0
Fordham1,1,Joseph Chartouny,JR,G,Fordham,A-10,29,1043,114,307,74,166,40,141,85,122,22,140,162,134,97,10,69,70,353
Fordham2,2,Prokop Slanina,JR,F,Fordham,A-10,29,922,145,291,110,196,35,95,39,51,45,102,147,42,36,37,44,103,364
Fordham3,3,Will Tavares,SR,G,Fordham,A-10,27,893,140,321,118,222,22,99,64,99,33,111,144,32,31,8,63,55,366
Fordham4,4,Ivan Raut,FR,F,Fordham,A-10,31,891,88,229,33,63,55,166,29,35,11,102,113,47,28,0,47,49,260
Fordham5,5,Cavit Havsa,SO,G,Fordham,A-10,30,746,46,102,37,61,9,41,19,25,15,42,57,93,27,4,43,41,120
Fordham6,6,Perris Hicks,SR,G,Fordham,A-10,29,713,65,166,30,54,35,112,42,56,8,28,36,29,36,0,27,63,207
Fordham7,7,David Pekarek,JR,F,Fordham,A-10,27,466,49,145,24,49,25,96,18,28,14,70,84,13,11,12,26,41,141
Fordham8,8,Tre Evans,SO,G,Fordham,A-10,13,335,29,79,24,50,5,29,21,31,0,31,31,27,11,0,16,34,84
Fordham9,9,Brenton Petty,,G,Fordham,A-10,15,62,1,6,1,4,0,2,0,0,2,5,7,0,2,0,1,14,2
Fordham10,10,Chris Downing,,F,Fordham,A-10,17,56,4,7,4,7,0,0,1,1,3,5,8,1,1,0,3,7,9
Fordham11,11,Thomas Sanchez,SR,G,Fordham,A-10,15,46,2,8,1,3,1,5,0,0,0,0,0,0,0,0,1,0,5
Fordham12,12,Jesse Bunting,JR,F,Fordham,A-10,5,45,7,10,7,10,0,0,2,2,6,5,11,1,1,1,1,6,16
Fordham13,13,Chuba Ohams,SO,F,Fordham,A-10,3,32,2,9,2,8,0,1,0,2,3,2,5,0,2,2,2,8,4
Fordham14,14,Peter Burquest,,G,Fordham,A-10,1,1,0,0,0,0,0,0,0,0,0,0,0,0,0,0,0,0,0
Fresno State1,1,Deshon Taylor,JR,G,Fresno State,MWC,32,1083,154,352,95,199,59,153,200,240,12,89,101,83,49,5,79,72,567
Fresno State2,2,Ray Bowles,SR,G,Fresno State,MWC,32,1020,123,284,89,180,34,104,58,95,20,88,108,65,31,4,46,78,338
Fresno State3,3,Bryson Williams,SO,F,Fresno State,MWC,32,916,193,323,192,319,1,4,56,93,60,135,195,37,16,21,59,102,443
Fresno State4,4,Jahmel Taylor,SR,G,Fresno State,MWC,32,884,97,232,25,63,72,169,32,44,14,98,112,76,26,4,31,69,298
Fresno State5,5,Sam Bittner,JR,F,Fresno State,MWC,32,817,57,113,18,32,39,81,16,20,27,65,92,52,35,10,27,91,169
Fresno State6,6,Jaron Hopkins,SR,G,Fresno State,MWC,25,716,116,229,109,210,7,19,45,78,22,120,142,77,35,9,59,57,284
Fresno State7,7,Terrell Carter,SR,C,Fresno State,MWC,32,446,72,130,72,130,0,0,38,51,31,56,87,9,10,17,42,83,182
Fresno State8,8,Nate Grimes,SO,F,Fresno State,MWC,29,363,57,90,57,90,0,0,18,40,64,94,158,5,7,32,17,54,132
Fresno State9,9,Johnny McWilliams,SO,G,Fresno State,MWC,23,174,13,41,9,27,4,14,8,17,5,8,13,10,7,2,4,18,38
Fresno State10,10,Myles Fitzgerald-Warren,,G,Fresno State,MWC,7,17,0,2,0,1,0,1,0,1,0,0,0,0,0,0,1,0,0
Fresno State11,11,Lazaro Rojas,FR,F,Fresno State,MWC,8,17,1,3,1,2,0,1,0,0,2,2,4,1,0,0,1,1,2
Fresno State12,12,Gilles Dekoninck,FR,F,Fresno State,MWC,7,14,1,3,1,2,0,1,1,2,0,2,2,0,0,0,1,1,3
Fresno State13,13,New Williams,,G,Fresno State,MWC,4,8,1,3,1,2,0,1,1,1,0,0,0,0,1,0,2,0,3
Furman1,1,Daniel Fowler,SR,G,Furman,Southern,33,948,131,280,76,146,55,134,60,72,46,84,130,102,44,7,46,69,377
Furman2,2,John Davis,SR,G,Furman,Southern,33,915,137,282,93,168,44,114,56,74,14,74,88,85,47,2,47,43,374
Furman3,3,Matt Rafferty,JR,F,Furman,Southern,33,868,147,246,134,207,13,39,64,89,74,162,236,91,54,21,33,82,371
Furman4,4,Devin Sibley,SR,G,Furman,Southern,32,850,172,373,121,221,51,152,58,106,14,143,157,63,25,10,87,63,453
Furman5,5,Andrew Brown,JR,G,Furman,Southern,32,786,93,196,32,55,61,141,29,38,28,75,103,66,37,4,32,63,276
Furman6,6,Jordan Lyons,SO,G,Furman,Southern,33,596,87,236,29,57,58,179,41,52,3,48,51,25,18,1,47,32,273
Furman7,7,Alex Hunter,FR,G,Furman,Southern,33,463,40,86,21,35,19,51,7,9,5,44,49,37,5,1,16,32,106
Furman8,8,Clay Mounce,FR,F,Furman,Southern,29,383,59,105,54,81,5,24,26,39,36,51,87,12,19,8,13,47,149
Furman9,9,Geoff Beans,SR,F,Furman,Southern,33,374,34,112,3,9,31,103,21,26,10,32,42,15,5,3,12,43,120
Furman10,10,Jalen Williams,SO,F,Furman,Southern,30,286,29,59,29,59,0,0,22,34,47,62,109,9,7,15,25,44,80
Furman11,11,Jonathan Jean,JR,G,Furman,Southern,16,87,7,14,7,9,0,5,6,8,2,8,10,20,2,0,4,11,20
Furman12,12,Brady Schuck,JR,G,Furman,Southern,13,40,6,10,5,6,1,4,6,8,0,6,6,1,1,0,2,1,19
Furman13,13,Seve Stavroff,FR,G,Furman,Southern,12,29,0,7,0,3,0,4,1,2,1,3,4,0,1,0,1,1,1
Gardner-Webb1,1,Liam O'Reilly,,G,Gardner-Webb,Big South,32,1091,166,403,81,182,85,221,58,69,11,139,150,120,33,2,95,58,475
Gardner-Webb2,2,David Efianayi,JR,G,Gardner-Webb,Big South,32,1042,183,419,132,278,51,141,142,176,19,97,116,81,40,7,82,54,559
Gardner-Webb3,3,DJ Laster,JR,F,Gardner-Webb,Big South,32,844,188,372,167,306,21,66,45,74,63,109,172,14,18,13,61,79,442
Gardner-Webb4,4,Patrick Zeck,SO,F,Gardner-Webb,Big South,27,625,57,99,53,87,4,12,28,37,42,95,137,18,15,20,21,78,146
Gardner-Webb5,5,Jaheam Cornwall,FR,G,Gardner-Webb,Big South,27,600,71,159,28,61,43,98,24,30,10,56,66,66,25,0,40,42,209
Gardner-Webb6,6,Christian Turner,SO,G,Gardner-Webb,Big South,28,578,19,55,13,32,6,23,17,32,7,43,50,60,28,1,41,55,61
Gardner-Webb7,7,L'Hassane Niangane,,C,Gardner-Webb,Big South,32,522,14,40,14,40,0,0,9,30,68,65,133,7,1,30,30,85,37
Gardner-Webb8,8,Eric Jamison,SO,F,Gardner-Webb,Big South,27,412,41,83,40,75,1,8,21,28,17,84,101,10,8,3,15,46,104
Gardner-Webb9,9,Jamaal Robateau,SR,G,Gardner-Webb,Big South,18,329,25,85,13,39,12,46,9,13,6,51,57,15,11,5,13,23,71
Gardner-Webb10,10,Brandon Miller,JR,C,Gardner-Webb,Big South,10,167,21,36,21,36,0,0,7,10,8,22,30,2,6,3,12,32,49
Gardner-Webb11,11,Justin Jenkins,SO,G,Gardner-Webb,Big South,19,154,20,48,13,21,7,27,13,17,3,10,13,7,4,3,7,10,60
Gardner-Webb12,12,Nate Johnson,FR,G,Gardner-Webb,Big South,12,136,17,51,11,17,6,34,5,10,3,13,16,15,6,5,14,6,45
George Mason1,1,Otis Livingston II,JR,G,George Mason,A-10,33,1198,193,443,128,273,65,170,120,140,7,100,107,143,33,2,86,43,571
George Mason2,2,Justin Kier,SO,G,George Mason,A-10,33,1094,134,297,126,251,8,46,87,111,8,145,153,77,42,4,93,73,363
George Mason3,3,Goanar Mar,FR,F,George Mason,A-10,33,1053,109,253,69,141,40,112,102,128,62,82,144,27,22,4,59,93,360
George Mason4,4,Jaire Grayer,JR,G,George Mason,A-10,32,983,143,360,76,171,67,189,40,55,57,175,232,41,41,27,49,68,393
George Mason5,5,Ian Boyd,SO,G,George Mason,A-10,33,820,97,245,71,155,26,90,34,44,46,97,143,41,20,2,42,68,254
George Mason6,6,Greg Calixte,FR,F,George Mason,A-10,33,620,72,119,72,118,0,1,19,44,44,97,141,13,7,16,28,79,163
George Mason7,7,Javon Greene,FR,G,George Mason,A-10,33,583,51,143,31,60,20,83,25,39,4,87,91,31,25,7,31,58,147
George Mason8,8,A.J. Wilson,,F,George Mason,A-10,31,359,42,88,38,75,4,13,28,50,37,53,90,3,9,34,19,58,116
George Mason9,9,Zach Garrett,,G,George Mason,A-10,4,5,0,0,0,0,0,0,0,2,0,0,0,0,0,0,0,0,0
George Mason10,10,Nick Diclementi,,G,George Mason,A-10,4,5,0,1,0,0,0,1,0,0,0,2,2,0,1,0,1,0,0
George Mason11,11,Jack Tempchin,,G,George Mason,A-10,4,5,0,0,0,0,0,0,4,6,0,2,2,1,0,0,2,1,4
George Washington1,1,Yuta Watanabe,SR,G,George Washington,A-10,33,1207,193,442,137,288,56,154,96,119,42,158,200,52,26,54,51,50,538
George Washington2,2,Jair Bolden,SO,G,George Washington,A-10,32,1044,131,356,76,183,55,173,42,62,12,85,97,98,24,9,74,53,359
George Washington3,3,Terry Nolan Jr.,FR,G,George Washington,A-10,33,971,96,236,58,117,38,119,71,99,24,82,106,82,52,12,66,93,301
George Washington4,4,Patrick Steeves,SR,F,George Washington,A-10,33,944,142,272,138,259,4,13,38,52,59,116,175,66,20,13,69,57,326
George Washington5,5,Arnaldo Toro,SO,F,George Washington,A-10,33,842,91,217,84,183,7,34,69,90,88,141,229,39,20,27,39,63,258
George Washington6,6,Bo Zeigler,SR,F,George Washington,A-10,33,617,107,171,107,171,0,0,25,43,45,50,95,21,18,36,43,79,239
George Washington7,7,Justin Mazzulla,FR,G,George Washington,A-10,33,565,30,68,24,48,6,20,20,45,23,48,71,67,18,3,41,53,86
George Washington8,8,Maceo Jack,FR,G,George Washington,A-10,24,198,24,53,13,26,11,27,9,11,6,14,20,8,3,4,16,20,68
George Washington9,9,Justin Williams,SO,G,George Washington,A-10,21,127,15,27,14,22,1,5,4,6,10,21,31,2,4,3,4,11,35
George Washington10,10,Adam Mitola,SO,G,George Washington,A-10,13,34,0,8,0,1,0,7,1,2,1,4,5,3,1,0,1,3,1
George Washington11,11,Javier Langarica,FR,F,George Washington,A-10,10,27,2,9,1,2,1,7,6,8,2,8,10,0,3,2,2,4,11
George Washington12,12,Jack Granger,,G,George Washington,A-10,8,14,1,2,0,0,1,2,0,0,0,3,3,1,0,0,0,0,3
George Washington13,13,Luke Sasser,,F,George Washington,A-10,7,10,0,0,0,0,0,0,0,0,0,0,0,1,0,0,0,0,0
Georgetown1,1,Jessie Govan,JR,C,Georgetown,Big East,30,980,201,396,185,350,16,46,118,155,74,227,301,59,18,34,52,87,536
Georgetown2,2,Marcus Derrickson,JR,F,Georgetown,Big East,29,927,150,297,103,196,47,101,113,131,67,167,234,46,20,19,63,70,460
Georgetown3,3,Jamorko Pickett,FR,F,Georgetown,Big East,30,826,95,262,39,105,56,157,41,55,17,95,112,53,12,17,73,57,287
Georgetown4,4,Kaleb Johnson,JR,G,Georgetown,Big East,30,813,84,155,68,108,16,47,54,73,47,78,125,60,18,21,43,67,238
Georgetown5,5,Jagan Mosely,SO,G,Georgetown,Big East,30,696,70,144,56,108,14,36,44,65,9,74,83,86,25,6,61,55,198
Georgetown6,6,Jonathan Mulmore,SR,G,Georgetown,Big East,30,683,45,98,30,66,15,32,63,82,11,52,63,102,29,5,56,78,168
Georgetown7,7,Jahvon Blair,FR,G,Georgetown,Big East,30,645,81,244,32,92,49,152,60,70,26,39,65,52,12,0,44,32,271
Georgetown8,8,Trey Dickerson,SR,G,Georgetown,Big East,27,363,47,110,36,70,11,40,15,28,9,23,32,57,22,2,39,51,120
Georgetown9,9,Antwan Walker,FR,F,Georgetown,Big East,24,183,24,49,22,44,2,5,14,15,20,26,46,6,7,3,11,22,64
Georgetown10,10,Chris Sodom,FR,C,Georgetown,Big East,6,27,2,4,2,4,0,0,0,0,3,5,8,0,0,3,2,11,4
Georgetown11,11,George Muresan,SO,F,Georgetown,Big East,6,17,1,1,1,1,0,0,0,0,0,0,0,0,0,0,0,0,2
Georgetown12,12,Ra'Mond Hines,,G,Georgetown,Big East,6,15,0,3,0,1,0,2,2,2,0,1,1,1,1,0,0,1,2
Georgia1,1,Yante Maten,SR,F,Georgia,SEC,33,1131,207,447,178,362,29,85,193,241,116,167,283,51,15,49,67,72,636
Georgia2,2,William Jackson II,JR,G,Georgia,SEC,33,976,92,264,40,98,52,166,41,54,9,63,72,115,23,5,61,67,277
Georgia3,3,Juwan Parker,SR,G,Georgia,SEC,33,806,86,221,59,147,27,74,72,84,18,103,121,38,13,5,42,54,271
Georgia4,4,Rayshaun Hammonds,FR,F,Georgia,SEC,33,797,82,195,66,139,16,56,41,59,49,113,162,45,15,6,43,81,221
Georgia5,5,Derek Ogbeide,JR,F,Georgia,SEC,33,722,101,171,101,170,0,1,26,55,61,142,203,22,11,29,38,66,228
Georgia6,6,Nicolas Claxton,FR,F,Georgia,SEC,33,485,44,98,36,76,8,22,34,65,55,74,129,6,5,42,24,57,130
Georgia7,7,Tyree Crump,SO,G,Georgia,SEC,31,460,61,175,17,42,44,133,34,45,0,37,37,39,12,2,37,24,200
Georgia8,8,TeShaun Hightower,FR,G,Georgia,SEC,29,321,35,93,23,52,12,41,23,51,2,40,42,39,9,2,30,26,105
Georgia9,9,E'Torrion Wilridge,,F,Georgia,SEC,28,289,10,35,7,11,3,24,9,16,6,26,32,21,5,6,18,7,32
Georgia10,10,Jordan Harris,SO,G,Georgia,SEC,18,285,22,53,16,31,6,22,16,24,5,32,37,15,8,3,15,29,66
Georgia11,11,Mike Edwards,JR,F,Georgia,SEC,29,274,18,47,18,47,0,0,16,26,19,34,53,6,5,5,13,34,52
Georgia12,12,Pape Diatta,SR,F,Georgia,SEC,15,121,5,14,1,6,4,8,4,8,4,14,18,5,4,1,5,14,18
Georgia13,13,Isaac Kante,FR,F,Georgia,SEC,10,23,4,8,4,8,0,0,2,2,2,2,4,0,0,1,3,2,10
Georgia14,14,Connor O'Neill,,F,Georgia,SEC,3,7,0,5,0,5,0,0,1,2,4,0,4,0,1,0,2,0,1
Georgia15,15,Christian Harrison,JR,G,Georgia,SEC,2,3,0,0,0,0,0,0,0,0,0,1,1,0,0,0,0,0,0
Georgia Southern1,1,Tookie Brown,JR,G,Georgia Southern,Sun Belt,32,1035,190,356,141,252,49,104,177,235,20,110,130,137,56,10,80,79,606
Georgia Southern2,2,Mike Hughes,SR,G,Georgia Southern,Sun Belt,33,1009,105,306,47,126,58,180,105,133,21,129,150,57,34,13,49,78,373
Georgia Southern3,3,Jake Allsmiller,SR,G,Georgia Southern,Sun Belt,33,847,92,251,9,19,83,232,17,23,10,42,52,21,9,6,14,87,284
Georgia Southern4,4,Montae Glenn,JR,F,Georgia Southern,Sun Belt,30,768,111,204,110,203,1,1,46,73,126,117,243,11,20,42,34,70,269
Georgia Southern5,5,Ike Smith,JR,G,Georgia Southern,Sun Belt,28,708,125,318,83,174,42,144,42,75,18,101,119,25,13,19,63,64,334
Georgia Southern6,6,Quan Jackson,FR,G,Georgia Southern,Sun Belt,33,689,79,192,55,121,24,71,49,93,30,75,105,29,48,9,33,53,231
Georgia Southern7,7,Shawn O'Connell,,F,Georgia Southern,Sun Belt,32,396,46,64,46,63,0,1,17,33,39,58,97,5,15,14,16,54,109
Georgia Southern8,8,Coye Simmons,SR,F,Georgia Southern,Sun Belt,33,387,26,59,26,58,0,1,19,25,51,73,124,7,6,1,16,66,71
Georgia Southern9,9,B.J. Gladden,SR,F,Georgia Southern,Sun Belt,28,312,28,85,28,81,0,4,24,60,19,52,71,14,5,3,18,31,80
Georgia Southern10,10,David-Lee Jones Jr.,SO,G,Georgia Southern,Sun Belt,30,303,33,90,23,53,10,37,15,20,4,19,23,21,11,1,28,39,91
Georgia Southern11,11,Jared Hamilton,SO,G,Georgia Southern,Sun Belt,8,151,20,56,20,54,0,2,12,17,9,10,19,6,8,1,9,10,52
Georgia Southern12,12,DeDe Reynolds,,G,Georgia Southern,Sun Belt,5,12,2,6,2,4,0,2,0,0,3,1,4,0,1,0,1,1,4
Georgia Southern13,13,Tione Jones,SR,G,Georgia Southern,Sun Belt,5,8,0,5,0,0,0,5,0,0,0,1,1,0,1,1,0,1,0
Georgia State1,1,D'Marcus Simonds,,G,Georgia State,Sun Belt,33,1151,259,562,222,429,37,133,136,197,43,149,192,148,57,23,120,94,691
Georgia State2,2,Malik Benlevi,JR,F,Georgia State,Sun Belt,33,1150,111,247,44,91,67,156,28,40,48,167,215,59,45,30,23,73,317
Georgia State3,3,Jeff Thomas,JR,F,Georgia State,Sun Belt,33,1043,129,272,68,119,61,153,42,50,25,117,142,40,31,25,31,70,361
Georgia State4,4,Devin Mitchell,,G,Georgia State,Sun Belt,33,943,138,307,44,96,94,211,33,50,10,72,82,65,23,5,48,78,403
Georgia State5,5,Jordan Session,SR,F,Georgia State,Sun Belt,33,851,99,182,93,168,6,14,50,94,69,131,200,30,41,39,45,113,254
Georgia State6,6,Isaiah Williams,SR,G,Georgia State,Sun Belt,32,632,76,181,36,76,40,105,42,48,7,37,44,50,15,1,29,27,234
Georgia State7,7,Kane Williams,FR,G,Georgia State,Sun Belt,32,357,32,68,31,56,1,12,51,72,13,33,46,41,21,2,30,50,116
Georgia State8,8,Jordan Tyson,JR,F,Georgia State,Sun Belt,33,335,29,55,29,55,0,0,9,21,18,46,64,2,3,20,23,66,67
Georgia State9,9,Josh Linder,FR,F,Georgia State,Sun Belt,21,110,13,27,13,26,0,1,6,17,11,11,22,3,2,3,10,25,32
Georgia State10,10,Chris Clerkley,SO,F,Georgia State,Sun Belt,16,47,0,4,0,4,0,0,0,1,2,7,9,3,0,2,3,4,0
Georgia State11,11,Denis Alibegovic,FR,G,Georgia State,Sun Belt,17,24,2,13,1,5,1,8,0,0,0,0,0,1,0,0,1,0,5
Georgia State12,12,Matt Chism,FR,G,Georgia State,Sun Belt,12,19,3,3,3,3,0,0,1,2,0,2,2,1,0,0,1,1,7
Georgia State13,13,Nile Felton,SO,G,Georgia State,Sun Belt,11,13,0,3,0,1,0,2,0,0,1,2,3,0,0,0,0,2,0
Georgia Tech1,1,Ben Lammers,SR,C,Georgia Tech,ACC,32,1151,151,327,149,317,2,10,71,95,77,182,259,54,39,78,47,67,375
Georgia Tech2,2,Jose Alvarado,FR,G,Georgia Tech,ACC,25,874,99,221,59,113,40,108,65,81,15,78,93,77,43,2,59,60,303
Georgia Tech3,3,Josh Okogie,,G,Georgia Tech,ACC,24,873,133,320,95,220,38,100,133,162,54,96,150,59,42,23,61,70,437
Georgia Tech4,4,Tadric Jackson,SR,G,Georgia Tech,ACC,29,839,149,335,121,237,28,98,41,67,23,83,106,63,26,5,66,63,367
Georgia Tech5,5,Brandon Alston,JR,G,Georgia Tech,ACC,32,758,56,150,35,91,21,59,41,58,18,39,57,50,11,1,36,48,174
Georgia Tech6,6,Abdoulaye Gueye,JR,F,Georgia Tech,ACC,31,672,71,152,69,141,2,11,38,63,54,83,137,33,20,33,44,88,182
Georgia Tech7,7,Moses Wright,FR,F,Georgia Tech,ACC,25,413,35,114,33,83,2,31,19,35,25,60,85,17,16,13,29,42,91
Georgia Tech8,8,Curtis Haywood II,FR,G,Georgia Tech,ACC,15,364,24,62,7,16,17,46,15,18,8,35,43,35,13,5,17,32,80
Georgia Tech9,9,Evan Cole,FR,F,Georgia Tech,ACC,24,332,29,63,23,41,6,22,13,26,18,44,62,11,7,8,15,44,77
Georgia Tech10,10,Justin Moore,SO,G,Georgia Tech,ACC,8,110,3,18,3,14,0,4,1,4,0,7,7,10,4,0,14,11,7
Georgia Tech11,11,Sylvester Ogbonda,SO,F,Georgia Tech,ACC,9,21,3,5,3,5,0,0,1,3,3,4,7,0,0,3,5,5,7
Georgia Tech12,12,Malachi Rice,FR,G,Georgia Tech,ACC,6,6,0,1,0,1,0,0,0,0,0,0,0,0,0,0,1,0,0
Georgia Tech13,13,Jon Brown,FR,G,Georgia Tech,ACC,3,5,0,0,0,0,0,0,0,2,0,0,0,0,0,0,1,1,0
Georgia Tech14,14,Evan Jester,FR,F,Georgia Tech,ACC,3,4,0,1,0,0,0,1,1,2,0,1,1,0,0,0,1,1,1
Georgia Tech15,15,Avi Schafer,FR,C,Georgia Tech,ACC,4,3,0,1,0,1,0,0,0,0,1,1,2,0,0,0,0,1,0
Gonzaga1,1,Josh Perkins,JR,G,Gonzaga,WCC,34,1109,142,324,62,128,80,196,57,77,18,89,107,182,40,3,71,82,421
Gonzaga2,2,Silas Melson,SR,G,Gonzaga,WCC,34,1038,110,268,50,115,60,153,44,50,13,90,103,80,37,5,33,84,324
Gonzaga3,3,Johnathan Williams,SR,F,Gonzaga,WCC,34,995,182,322,174,289,8,33,88,157,79,202,281,55,27,40,71,90,460
Gonzaga4,4,Zach Norvell Jr.,FR,G,Gonzaga,WCC,34,888,145,306,79,124,66,182,56,68,32,92,124,80,39,3,52,72,412
Gonzaga5,5,Killian Tillie,SO,F,Gonzaga,WCC,34,880,178,300,133,210,45,90,55,72,59,145,204,57,26,36,53,82,456
Gonzaga6,6,Rui Hachimura,SO,F,Gonzaga,WCC,34,686,145,252,141,228,4,24,91,108,39,116,155,23,19,13,41,62,385
Gonzaga7,7,Corey Kispert,FR,F,Gonzaga,WCC,32,633,80,179,43,70,37,109,22,31,37,68,105,26,8,6,20,34,219
Gonzaga8,8,Jacob Larsen,FR,C,Gonzaga,WCC,32,283,36,54,36,54,0,0,28,42,31,60,91,17,4,15,25,37,100
Gonzaga9,9,Jeremy Jones,,F,Gonzaga,WCC,33,227,19,33,17,26,2,7,21,31,11,33,44,8,10,5,9,28,61
Gonzaga10,10,Jesse Wade,FR,G,Gonzaga,WCC,19,99,9,29,2,4,7,25,1,3,2,5,7,4,6,0,3,4,26
Gonzaga11,11,Jack Beach,SO,G,Gonzaga,WCC,15,39,0,9,0,5,0,4,2,4,1,3,4,2,3,0,0,2,2
Gonzaga12,12,Brian Pete,,G,Gonzaga,WCC,7,14,2,6,2,5,0,1,0,0,0,5,5,1,0,0,0,1,4
Gonzaga13,13,Alex Martin,SO,G,Gonzaga,WCC,3,6,1,3,1,1,0,2,1,2,1,0,1,0,0,0,0,1,3
Grambling1,1,Ivy Smith Jr.,SO,G,Grambling,SWAC,31,1089,149,373,124,304,25,69,194,241,25,114,139,154,67,5,110,94,517
Grambling2,2,Shirmane Thomas,SR,G,Grambling,SWAC,30,845,106,261,69,160,37,101,69,92,30,108,138,49,29,12,62,72,318
Grambling3,3,Axel Mpoyo,JR,F,Grambling,SWAC,31,798,90,215,87,192,3,23,61,91,55,118,173,7,24,21,58,87,244
Grambling4,4,Anthony Gaston,SO,G,Grambling,SWAC,30,773,102,259,78,169,24,90,51,71,28,59,87,43,45,5,52,80,279
Grambling5,5,Devante Jackson,SO,F,Grambling,SWAC,29,592,82,178,71,149,11,29,59,83,37,88,125,19,5,24,43,85,234
Grambling6,6,Jason Perry-Murray,SR,F,Grambling,SWAC,28,528,65,107,65,107,0,0,26,44,64,72,136,4,13,26,32,83,156
Grambling7,7,Nigel Ribeiro,JR,G,Grambling,SWAC,20,397,44,118,33,88,11,30,24,37,5,45,50,31,21,3,25,34,123
Grambling8,8,Drake Wilks,SO,G,Grambling,SWAC,28,384,44,102,22,42,22,60,10,18,21,40,61,11,12,4,27,33,120
Grambling9,9,Diontae Jones,SR,F,Grambling,SWAC,19,351,50,116,34,78,16,38,28,35,19,51,70,7,11,6,19,43,144
Grambling10,10,Bobby Jackson,JR,F,Grambling,SWAC,28,297,32,71,30,61,2,10,20,40,25,40,65,4,2,6,15,35,86
Grambling11,11,Kareem Wright,SO,G,Grambling,SWAC,21,148,9,36,7,19,2,17,4,10,1,11,12,12,7,0,20,22,24
Grambling12,12,Diing Diing Wol,JR,F,Grambling,SWAC,12,38,3,13,3,12,0,1,1,7,1,4,5,0,3,1,7,5,7
Grambling13,13,Charles Simmons,SO,G,Grambling,SWAC,5,10,1,3,0,1,1,2,0,0,1,0,1,1,0,0,0,1,3
Grand Canyon1,1,Joshua Braun,SR,G,Grand Canyon,WAC,33,979,118,310,54,128,64,182,89,120,45,78,123,47,26,17,49,67,389
Grand Canyon2,2,Casey Benson,SR,G,Grand Canyon,WAC,33,958,91,248,54,136,37,112,94,123,26,108,134,145,24,4,63,67,313
Grand Canyon3,3,Oscar Frayer,SO,G,Grand Canyon,WAC,32,845,117,243,78,137,39,106,35,64,56,115,171,41,38,23,47,79,308
Grand Canyon4,4,Keonta Vernon,SR,F,Grand Canyon,WAC,33,751,117,232,117,228,0,4,58,105,73,145,218,45,24,38,41,112,292
Grand Canyon5,5,Alessandro Lever,FR,F,Grand Canyon,WAC,33,695,137,297,111,219,26,78,104,135,42,105,147,40,12,13,58,88,404
Grand Canyon6,6,Gerard Martin,JR,G,Grand Canyon,WAC,33,543,38,96,20,34,18,62,12,27,17,78,95,41,19,6,27,61,106
Grand Canyon7,7,Roberts Blumbergs,FR,F,Grand Canyon,WAC,32,427,54,148,38,73,16,75,41,55,31,64,95,25,11,8,32,41,165
Grand Canyon8,8,Matt Jackson,JR,F,Grand Canyon,WAC,31,407,38,97,28,60,10,37,14,23,22,64,86,28,14,3,25,40,100
Grand Canyon9,9,Fiifi Aidoo,SO,G,Grand Canyon,WAC,31,377,44,111,26,47,18,64,14,19,16,23,39,32,15,6,21,39,120
Grand Canyon10,10,Shaq Carr,SR,G,Grand Canyon,WAC,18,286,27,53,24,45,3,8,22,24,7,24,31,48,5,4,33,27,79
Grand Canyon11,11,Damari Milstead,FR,G,Grand Canyon,WAC,25,241,30,63,20,44,10,19,48,57,3,17,20,26,11,2,28,21,118
Grand Canyon12,12,Kerwin Smith,JR,F,Grand Canyon,WAC,16,78,8,13,8,13,0,0,3,7,7,11,18,3,1,4,7,14,19
Grand Canyon13,13,Ibrahima Sankare,FR,G,Grand Canyon,WAC,9,34,4,8,4,8,0,0,5,7,2,6,8,1,5,1,3,4,13
Grand Canyon14,14,Cheick Sy-Savane,,G,Grand Canyon,WAC,6,14,3,9,0,4,3,5,0,0,1,0,1,0,0,0,1,4,9
Grand Canyon15,15,Nehemiah Allen,,G,Grand Canyon,WAC,5,11,1,2,1,1,0,1,1,2,0,0,0,0,0,0,0,3,3
Grand Canyon16,16,Parker Dale,,G,Grand Canyon,WAC,3,4,0,1,0,1,0,0,1,2,1,0,1,0,0,0,1,1,1
Green Bay1,1,Khalil Small,SR,G,Green Bay,Horizon,33,1130,201,454,148,316,53,138,147,177,69,153,222,110,43,4,88,85,602
Green Bay2,2,Kameron Hankerson,SO,G,Green Bay,Horizon,33,906,127,287,79,163,48,124,51,69,20,81,101,87,32,21,78,76,353
Green Bay3,3,David Jesperson,SR,F,Green Bay,Horizon,33,819,97,227,43,82,54,145,19,23,31,100,131,32,15,17,36,67,267
Green Bay4,4,PJ Pipes,FR,G,Green Bay,Horizon,33,740,75,202,48,119,27,83,59,69,15,62,77,64,22,3,46,69,236
Green Bay5,5,Sandy Cohen,,G,Green Bay,Horizon,22,725,117,247,87,161,30,86,90,127,12,113,125,56,34,14,57,68,354
Green Bay6,6,Sukhjot Bains,JR,F,Green Bay,Horizon,33,517,38,88,31,59,7,29,15,33,31,59,90,38,17,9,22,55,98
Green Bay7,7,Manny Patterson,FR,F,Green Bay,Horizon,27,460,55,116,55,116,0,0,52,69,43,89,132,6,18,22,26,69,162
Green Bay8,8,Hunter Crist,FR,G,Green Bay,Horizon,30,443,38,94,19,45,19,49,21,33,7,44,51,36,14,1,39,72,116
Green Bay9,9,T.J. Parham,SO,F,Green Bay,Horizon,27,350,45,140,19,66,26,74,26,38,15,50,65,17,17,1,27,32,142
Green Bay10,10,Trevian Bell,FR,G,Green Bay,Horizon,26,326,39,101,26,67,13,34,16,22,10,54,64,9,10,5,17,22,107
Green Bay11,11,Will Chevalier,FR,F,Green Bay,Horizon,26,210,23,65,5,15,18,50,6,6,9,24,33,2,2,3,7,19,70
Green Bay12,12,Tyrone Powell,FR,F,Green Bay,Horizon,6,24,4,6,4,5,0,1,2,4,1,5,6,2,2,0,2,1,10
Hampton1,1,Jermaine Marrow,SO,G,Hampton,MEAC,34,1164,222,557,181,419,41,138,152,193,31,136,167,182,41,1,117,89,637
Hampton2,2,Kalin Fisher,JR,G,Hampton,MEAC,33,988,156,349,119,238,37,111,67,81,22,127,149,68,21,3,50,59,416
Hampton3,3,Akim Mitchell,JR,G,Hampton,MEAC,33,897,96,187,82,155,14,32,61,75,58,92,150,51,22,2,38,80,267
Hampton4,4,Greg Heckstall,SO,G,Hampton,MEAC,27,675,76,181,47,101,29,80,41,52,25,135,160,54,8,15,30,65,222
Hampton5,5,Trevond Barnes,JR,F,Hampton,MEAC,34,651,89,154,83,131,6,23,58,83,47,90,137,19,10,45,30,93,242
Hampton6,6,Malique Trent,,G,Hampton,MEAC,23,586,110,213,87,146,23,67,79,96,13,79,92,80,42,6,56,64,322
Hampton7,7,Charles Wilson-Fisher,SR,F,Hampton,MEAC,34,561,90,163,90,157,0,6,40,60,62,118,180,16,11,33,41,94,220
Hampton8,8,Lysander Bracey,SO,G,Hampton,MEAC,34,485,56,135,18,35,38,100,25,32,5,35,40,16,8,6,22,30,175
Hampton9,9,Austin Colbert,JR,F,Hampton,MEAC,25,320,29,81,24,52,5,29,11,13,15,43,58,9,5,9,17,42,74
Hampton10,10,Trey Carver,SO,G,Hampton,MEAC,30,257,24,54,24,52,0,2,24,35,21,24,45,3,8,1,11,32,72
Hampton11,11,A.J. Astroth,SR,F,Hampton,MEAC,6,69,7,17,7,15,0,2,5,6,5,16,21,3,2,3,3,10,19
Hampton12,12,Jaekwon Carliyle,,G,Hampton,MEAC,5,66,2,19,2,11,0,8,7,10,2,7,9,9,6,0,9,11,11
Hampton13,13,Eugene Marshall III,FR,G,Hampton,MEAC,10,36,4,14,3,4,1,10,3,4,1,5,6,3,1,0,1,7,12
Hampton14,14,Tre Houston,SO,G,Hampton,MEAC,10,28,3,6,3,5,0,1,2,4,1,6,7,2,1,0,2,0,8
Hartford1,1,J.R. Lynch,JR,G,Hartford,AEC,32,1153,148,349,99,211,49,138,83,100,11,131,142,121,46,2,77,87,428
Hartford2,2,Jason Dunne,JR,G,Hartford,AEC,32,1135,163,391,69,127,94,264,54,71,17,104,121,87,41,8,72,74,474
Hartford3,3,John Carroll,JR,F,Hartford,AEC,32,1005,170,360,151,297,19,63,129,181,54,152,206,76,17,30,66,87,488
Hartford4,4,Travis Weatherington,JR,G,Hartford,AEC,32,849,100,209,42,71,58,138,18,20,17,69,86,36,29,2,46,52,276
Hartford5,5,Hassan Attia,SR,C,Hartford,AEC,32,673,97,140,97,140,0,0,39,85,54,104,158,20,13,58,45,126,233
Hartford6,6,Jack Hobbs,SR,F,Hartford,AEC,32,596,44,143,14,25,30,118,15,19,22,75,97,18,18,10,22,55,133
Hartford7,7,George Blagojevic,JR,F,Hartford,AEC,31,544,59,112,57,101,2,11,23,40,36,79,115,37,17,11,30,50,143
Hartford8,8,Andrew Ramirez,JR,G,Hartford,AEC,27,194,17,43,13,29,4,14,8,17,2,18,20,12,10,0,15,20,46
Hartford9,9,Max Twyman,JR,G,Hartford,AEC,24,174,5,21,1,5,4,16,1,4,5,12,17,5,1,0,4,13,15
Hartford10,10,Jalen Knight,FR,G,Hartford,AEC,11,48,3,6,2,5,1,1,2,8,0,7,7,3,0,0,5,6,9
Hartford11,11,Mark Plousis,SR,G,Hartford,AEC,11,19,0,2,0,2,0,0,1,6,1,3,4,1,0,1,1,3,1
Hartford12,12,Petr Stepanyants,FR,F,Hartford,AEC,9,19,2,7,2,7,0,0,0,1,2,1,3,0,0,1,0,2,4
Hartford13,13,Nikola Colovic,FR,F,Hartford,AEC,4,8,0,0,0,0,0,0,0,1,0,2,2,0,0,0,0,6,0
Hartford14,14,Ziga Habat,FR,G,Hartford,AEC,4,8,1,1,1,1,0,0,2,2,0,0,0,0,0,0,0,2,4
Harvard1,1,Justin Bassey,SO,G,Harvard,Ivy,29,951,63,145,30,66,33,79,56,67,31,133,164,74,35,2,72,63,215
Harvard2,2,Corey Johnson,JR,G,Harvard,Ivy,29,823,64,175,12,22,52,153,11,13,7,76,83,36,15,4,19,60,191
Harvard3,3,Seth Towns,SO,F,Harvard,Ivy,29,814,156,370,94,230,62,140,93,116,30,134,164,53,24,18,64,72,467
Harvard4,4,Christian Juzang,SO,G,Harvard,Ivy,29,780,64,151,30,65,34,86,44,50,9,71,80,78,14,5,62,46,206
Harvard5,5,Chris Lewis,SO,F,Harvard,Ivy,30,778,161,264,161,264,0,0,63,92,60,110,170,36,16,47,48,82,385
Harvard6,6,Rio Haskett,FR,G,Harvard,Ivy,30,467,37,114,24,70,13,44,8,16,14,37,51,34,19,1,33,54,95
Harvard7,7,Danilo Djuricic,FR,F,Harvard,Ivy,29,417,55,128,34,62,21,66,19,25,30,50,80,8,5,17,16,43,150
Harvard8,8,Bryce Aiken,SO,G,Harvard,Ivy,14,388,57,152,41,84,16,68,67,83,2,27,29,41,4,0,38,24,197
Harvard9,9,Robert Baker,SO,F,Harvard,Ivy,21,234,17,52,11,27,6,25,12,15,10,50,60,13,11,10,16,28,52
Harvard10,10,Henry Welsh,SO,F,Harvard,Ivy,26,203,23,52,23,51,0,1,1,2,20,30,50,8,4,9,11,34,47
Harvard11,11,Reed Farley,FR,G,Harvard,Ivy,10,101,4,24,0,4,4,20,0,0,8,5,13,4,4,0,4,11,12
Harvard12,12,Weisner Perez,JR,F,Harvard,Ivy,11,89,11,22,11,21,0,1,2,3,8,13,21,1,4,0,8,13,24
Harvard13,13,Chris Egi,,F,Harvard,Ivy,4,28,5,7,5,7,0,0,0,1,3,3,6,1,3,2,1,2,10
Harvard14,14,Andre Chatfield,,G,Harvard,Ivy,5,19,1,5,0,2,1,3,0,0,1,0,1,2,1,0,2,3,3
Harvard15,15,Zach Yoshor,,G,Harvard,Ivy,4,16,0,1,0,1,0,0,0,0,1,0,1,0,0,0,1,1,0
Harvard16,16,Robbie Feinberg,,G,Harvard,Ivy,3,15,1,5,0,0,1,5,0,0,0,0,0,0,1,0,1,1,3
Harvard17,17,Balsa Dragovic,,F,Harvard,Ivy,1,1,0,0,0,0,0,0,0,0,0,0,0,0,0,0,0,1,0
Hawaii1,1,Sheriff Drammeh,JR,G,Hawaii,Big West,29,881,93,238,52,124,41,114,83,108,13,85,98,55,33,6,48,88,310
Hawaii2,2,Drew Buggs,FR,G,Hawaii,Big West,30,850,85,212,65,150,20,62,53,81,26,85,111,108,46,4,64,77,243
Hawaii3,3,Brocke Stepteau,JR,G,Hawaii,Big West,28,799,88,171,52,90,36,81,55,68,12,45,57,75,14,0,46,55,267
Hawaii4,4,Jack Purchase,JR,F,Hawaii,Big West,30,758,76,207,26,51,50,156,23,35,24,128,152,63,16,16,35,59,225
Hawaii5,5,Gibson Johnson,SR,F,Hawaii,Big West,30,698,112,209,104,189,8,20,79,116,48,92,140,40,19,19,44,79,311
Hawaii6,6,Leland Green,SO,G,Hawaii,Big West,30,690,66,196,38,98,28,98,9,22,13,45,58,25,22,2,47,56,169
Hawaii7,7,Mike Thomas,SR,F,Hawaii,Big West,28,651,125,223,119,198,6,25,108,154,57,112,169,33,5,8,44,87,364
Hawaii8,8,Zigmars Raimo,SO,F,Hawaii,Big West,25,213,21,36,21,36,0,0,25,42,23,20,43,12,7,1,18,23,67
Hawaii9,9,Samuta Avea,FR,G,Hawaii,Big West,27,205,28,62,23,40,5,22,6,10,13,32,45,9,4,1,16,19,67
Hawaii10,10,Brandon Thomas,SO,G,Hawaii,Big West,23,191,14,46,6,13,8,33,6,13,4,14,18,7,2,1,5,15,42
Hawaii11,11,Ido Flaisher,SO,C,Hawaii,Big West,22,123,10,23,10,23,0,0,8,15,4,20,24,1,0,1,12,25,28
Hawaii12,12,Zach Buscher,JR,G,Hawaii,Big West,10,16,3,6,3,4,0,2,5,6,1,4,5,0,1,0,6,1,11
High Point1,1,Andre Fox,JR,G,High Point,Big South,29,829,150,316,95,187,55,129,99,132,15,125,140,40,36,8,59,63,454
High Point2,2,Jahaad Proctor,SO,G,High Point,Big South,25,798,143,331,88,187,55,144,70,89,17,74,91,74,25,7,60,35,411
High Point3,3,Brandon Kamga,SO,G,High Point,Big South,28,757,108,260,91,216,17,44,71,91,26,70,96,52,26,7,53,83,304
High Point4,4,Denny Slay,FR,G,High Point,Big South,30,662,58,147,43,96,15,51,22,30,8,46,54,53,19,0,34,37,153
High Point5,5,Jordan Whitehead,SR,F,High Point,Big South,30,623,68,114,68,112,0,2,20,42,62,74,136,21,19,5,19,63,156
High Point6,6,Justyn Mutts,FR,F,High Point,Big South,28,568,71,132,71,131,0,1,26,46,38,74,112,39,30,32,42,86,168
High Point7,7,Austin White,SR,G,High Point,Big South,30,516,37,101,37,93,0,8,22,31,7,28,35,18,23,2,15,53,96
High Point8,8,Ricky Madison,JR,G,High Point,Big South,28,454,57,108,57,108,0,0,36,53,49,72,121,9,11,6,23,48,150
High Point9,9,Luke Vargo,SO,F,High Point,Big South,30,320,24,59,11,20,13,39,9,14,8,37,45,8,3,3,13,29,70
High Point10,10,Jamal Wright,SO,G,High Point,Big South,24,296,23,59,19,39,4,20,27,38,2,24,26,34,23,2,31,30,77
High Point11,11,Cliff Thomas Jr.,SO,F,High Point,Big South,18,92,21,26,21,26,0,0,8,10,7,20,27,0,0,7,3,10,50
High Point12,12,Sam Berlin,JR,C,High Point,Big South,15,61,9,16,9,16,0,0,3,11,15,15,30,2,2,1,3,6,21
High Point13,13,Dexter Gooding,JR,G,High Point,Big South,14,49,6,21,2,3,4,18,0,1,0,9,9,3,5,2,3,2,16
Hofstra1,1,Justin Wright-Foreman,JR,G,Hofstra,CAA,31,1171,264,588,168,326,96,262,131,164,10,93,103,100,25,7,69,62,755
Hofstra2,2,Eli Pemberton,SO,G,Hofstra,CAA,30,1046,145,321,91,189,54,132,132,175,48,96,144,67,20,5,61,75,476
Hofstra3,3,Rokas Gustys,SR,F,Hofstra,CAA,31,921,141,220,141,220,0,0,45,120,127,245,372,40,26,11,53,100,327
Hofstra4,4,Desure Buie,JR,G,Hofstra,CAA,30,670,66,152,44,89,22,63,39,48,6,40,46,100,22,1,44,50,193
Hofstra5,5,Jalen Ray,FR,G,Hofstra,CAA,31,650,62,172,14,51,48,121,42,58,7,37,44,36,24,6,22,63,214
Hofstra6,6,Kenny Wormley,JR,G,Hofstra,CAA,30,444,42,116,31,92,11,24,24,36,8,31,39,39,9,0,33,63,119
Hofstra7,7,Stafford Trueheart,SO,F,Hofstra,CAA,28,404,35,78,21,36,14,42,22,30,17,55,72,4,11,24,14,52,106
Hofstra8,8,Joel Angus III,SR,F,Hofstra,CAA,21,360,42,87,42,87,0,0,19,23,31,47,78,8,8,5,10,33,103
Hofstra9,9,Hunter Sabety,SR,F,Hofstra,CAA,31,287,53,73,53,73,0,0,7,18,31,51,82,11,6,23,13,57,113
Hofstra10,10,Matija Radovic,FR,F,Hofstra,CAA,25,260,17,60,3,12,14,48,7,12,13,33,46,7,5,1,12,21,55
Hofstra11,11,Connor Klementowicz,SO,G,Hofstra,CAA,7,12,1,1,0,0,1,1,0,2,0,1,1,1,0,0,2,0,3
Holy Cross1,1,Caleb Green,FR,G,Holy Cross,Patriot,31,1030,104,254,70,144,34,110,33,45,13,62,75,88,25,0,58,51,275
Holy Cross2,2,Jehyve Floyd,JR,F,Holy Cross,Patriot,31,924,165,247,165,247,0,0,47,97,33,140,173,50,29,67,72,104,377
Holy Cross3,3,Jacob Grandison,FR,F,Holy Cross,Patriot,31,852,100,226,62,106,38,120,40,54,24,117,141,61,24,5,55,74,278
Holy Cross4,4,Pat Benzan,JR,G,Holy Cross,Patriot,28,764,57,139,52,112,5,27,58,73,14,79,93,58,30,0,34,52,177
Holy Cross5,5,Austin Butler,FR,G,Holy Cross,Patriot,30,739,106,251,67,132,39,119,44,63,29,81,110,33,23,4,27,69,295
Holy Cross6,6,Karl Charles,JR,F,Holy Cross,Patriot,22,652,70,160,48,81,22,79,62,80,11,52,63,69,33,5,51,55,224
Holy Cross7,7,Matt Zignorski,JR,G,Holy Cross,Patriot,28,475,31,80,12,28,19,52,14,18,1,26,27,30,9,3,11,28,95
Holy Cross8,8,Matt Faw,FR,F,Holy Cross,Patriot,31,330,47,95,26,51,21,44,19,25,5,47,52,12,9,13,25,70,134
Holy Cross9,9,Connor Niego,FR,F,Holy Cross,Patriot,22,284,27,71,14,29,13,42,2,4,8,33,41,5,5,8,16,19,69
Holy Cross10,10,Kyle Copeland,FR,G,Holy Cross,Patriot,17,100,9,23,2,4,7,19,2,4,2,9,11,6,4,0,4,12,27
Holy Cross11,11,Clayton Le Sann,SO,G,Holy Cross,Patriot,13,91,8,21,3,10,5,11,0,2,6,5,11,6,3,0,2,3,21
Holy Cross12,12,Will Powers,SO,G,Holy Cross,Patriot,5,5,0,0,0,0,0,0,0,0,0,0,0,0,0,0,0,0,0
Holy Cross13,13,Jack Stevens,,C,Holy Cross,Patriot,2,4,0,1,0,1,0,0,0,0,1,1,2,0,0,0,0,0,0
Houston1,1,Robert Gray Jr.,SR,G,Houston,AAC,31,973,192,419,141,272,51,147,141,174,18,84,102,142,36,4,68,48,576
Houston2,2,Corey Davis Jr.,JR,G,Houston,AAC,32,950,140,308,43,86,97,222,54,68,22,77,99,79,29,1,46,61,431
Houston3,3,Devin Davis,SR,F,Houston,AAC,32,823,143,285,142,278,1,7,55,81,53,144,197,44,22,21,35,89,342
Houston4,4,Galen Robinson Jr.,JR,G,Houston,AAC,32,771,59,130,56,109,3,21,28,41,10,61,71,120,41,3,56,62,149
Houston5,5,Armoni Brooks,SO,G,Houston,AAC,32,655,109,248,27,58,82,190,22,27,26,90,116,17,26,11,13,43,322
Houston6,6,Fabian White Jr.,FR,F,Houston,AAC,32,532,73,132,73,132,0,0,38,53,53,76,129,26,15,31,38,84,184
Houston7,7,Wes VanBeck,SR,G,Houston,AAC,28,475,51,121,17,32,34,89,37,48,27,52,79,31,15,2,31,52,173
Houston8,8,Nura Zanna,SR,F,Houston,AAC,32,446,35,64,35,64,0,0,20,43,55,71,126,5,8,3,29,95,90
Houston9,9,Breaon Brady,JR,F,Houston,AAC,30,384,57,103,57,103,0,0,21,32,45,86,131,6,5,10,42,93,135
Houston10,10,Chris Harris,SO,C,Houston,AAC,21,160,16,24,16,24,0,0,4,17,9,32,41,1,1,11,11,29,36
Houston11,11,Gabe Grant,JR,F,Houston,AAC,23,124,14,44,4,15,10,29,14,22,8,18,26,4,4,3,3,7,52
Houston12,12,Valentine Sangoyomi,JR,C,Houston,AAC,13,58,2,10,2,10,0,0,4,6,4,12,16,2,0,1,6,7,8
Houston13,13,Mike Adewunmi,FR,G,Houston,AAC,14,36,0,8,0,1,0,7,2,4,1,5,6,2,2,0,0,2,2
Houston14,14,Cedrick Alley Jr,FR,F,Houston,AAC,2,13,0,2,0,0,0,2,0,0,0,1,1,1,0,0,0,2,0
Houston Baptist1,1,Braxton Bonds,JR,G,Houston Baptist,Southland,31,1020,123,314,116,270,7,44,66,108,53,109,162,158,59,3,72,63,319
Houston Baptist2,2,David Caraher,FR,F,Houston Baptist,Southland,29,908,162,356,106,202,56,154,89,121,70,138,208,55,24,4,69,83,469
Houston Baptist3,3,Ian Dubose,FR,G,Houston Baptist,Southland,31,886,129,318,94,218,35,100,93,150,55,116,171,61,44,12,68,92,386
Houston Baptist4,4,Jalon Gates,SO,G,Houston Baptist,Southland,31,577,111,294,36,78,75,216,60,78,12,30,42,15,8,0,18,23,357
Houston Baptist5,5,William Gates,SR,G,Houston Baptist,Southland,29,575,69,158,60,118,9,40,17,37,11,28,39,15,10,2,22,31,164
Houston Baptist6,6,Philip McKenzie,FR,F,Houston Baptist,Southland,31,503,40,95,35,73,5,22,14,33,50,53,103,14,9,7,25,54,99
Houston Baptist7,7,Oliver Lynch-Daniels,FR,G,Houston Baptist,Southland,30,494,58,154,34,87,24,67,22,30,24,30,54,50,16,6,34,60,162
Houston Baptist8,8,Edward Hardt,JR,C,Houston Baptist,Southland,30,470,63,123,62,120,1,3,29,54,35,65,100,12,11,7,42,66,156
Houston Baptist9,9,Tim Myles,SR,F,Houston Baptist,Southland,24,242,23,52,22,51,1,1,11,26,32,40,72,13,11,14,40,66,58
Houston Baptist10,10,Josh Ibarra,SR,C,Houston Baptist,Southland,9,239,58,105,58,105,0,0,28,46,43,47,90,22,3,14,20,23,144
Houston Baptist11,11,Chukuka Emili,JR,F,Houston Baptist,Southland,23,232,16,57,12,38,4,19,5,13,16,31,47,3,4,19,13,35,41
Houston Baptist12,12,Stephen O'Suji,,G,Houston Baptist,Southland,12,52,2,13,2,12,0,1,5,6,2,6,8,6,4,0,4,4,9
Houston Baptist13,13,Tyquon Jordan,SO,G,Houston Baptist,Southland,7,25,5,9,3,4,2,5,4,8,3,2,5,1,1,1,3,5,16
Houston Baptist14,14,Michael Saladin,SO,G,Houston Baptist,Southland,7,19,1,6,1,2,0,4,0,0,0,2,2,1,2,0,0,0,2
Houston Baptist15,15,Waseem Ali Jr.,FR,G,Houston Baptist,Southland,3,8,0,4,0,3,0,1,0,0,1,1,2,0,0,0,1,0,0
Howard1,1,RJ Cole,FR,G,Howard,MEAC,33,1252,242,613,133,309,109,304,191,248,27,103,130,198,56,0,127,88,784
Howard2,2,Charles Williams,SO,F,Howard,MEAC,33,1173,253,567,179,386,74,181,93,119,23,89,112,20,28,10,58,72,673
Howard3,3,Zion Cousins,FR,F,Howard,MEAC,29,864,66,132,66,129,0,3,36,65,63,144,207,15,11,34,28,79,168
Howard4,4,Jalen Jones,JR,F,Howard,MEAC,33,721,44,75,43,73,1,2,22,44,58,103,161,30,20,16,40,92,111
Howard5,5,Cameron Lewis,JR,C,Howard,MEAC,33,645,51,98,50,96,1,2,28,40,52,68,120,33,13,15,41,97,131
Howard6,6,Kyle Foster,FR,G,Howard,MEAC,33,594,62,204,9,33,53,171,34,52,5,55,60,25,17,6,40,63,211
Howard7,7,Dalique Mingo,SR,G,Howard,MEAC,33,563,47,118,42,92,5,26,56,67,24,55,79,44,17,3,46,57,155
Howard8,8,Marcus Hall,SO,F,Howard,MEAC,29,364,28,40,28,40,0,0,12,25,30,44,74,16,5,3,14,71,68
Howard9,9,Nate Garvey,FR,G,Howard,MEAC,30,190,19,66,6,18,13,48,8,13,2,11,13,12,6,3,8,14,59
Howard10,10,Michael Obindu,,C,Howard,MEAC,19,130,7,17,7,17,0,0,2,5,6,22,28,4,2,2,5,22,16
Howard11,11,Kai Tease,FR,G,Howard,MEAC,10,121,14,43,3,14,11,29,4,6,3,5,8,4,2,0,10,7,43
Howard12,12,Ibrahim Dosunmu,FR,F,Howard,MEAC,10,69,12,15,12,14,0,1,1,4,10,13,23,3,1,0,5,10,25
Howard13,13,Justin Cotten,JR,G,Howard,MEAC,13,22,2,9,1,4,1,5,0,0,1,2,3,2,0,0,3,1,5
Howard14,14,Henry Odunze,FR,C,Howard,MEAC,6,14,0,0,0,0,0,0,0,0,1,2,3,0,0,1,0,3,0
Howard15,15,Phillip Jones,,G,Howard,MEAC,2,1,0,0,0,0,0,0,0,0,0,0,0,0,0,0,0,0,0
Idaho1,1,Victor Sanders,SR,G,Idaho,Big Sky,31,953,182,398,101,189,81,209,144,185,18,89,107,102,32,15,97,78,589
Idaho2,2,Jordan Scott,SR,F,Idaho,Big Sky,31,925,58,122,36,75,22,47,33,45,57,103,160,51,9,18,40,78,171
Idaho3,3,Nate Sherwood,JR,F,Idaho,Big Sky,31,904,112,211,98,182,14,29,58,70,57,88,145,54,17,12,48,78,296
Idaho4,4,Brayon Blake,SR,F,Idaho,Big Sky,31,898,202,403,150,288,52,115,70,106,65,233,298,38,22,15,60,93,526
Idaho5,5,Perrion Callandret,SR,G,Idaho,Big Sky,27,720,92,209,55,118,37,91,38,57,12,79,91,82,23,9,63,43,259
Idaho6,6,Chad Sherwood,SR,G,Idaho,Big Sky,31,653,53,123,10,26,43,97,6,8,7,45,52,52,11,5,24,64,155
Idaho7,7,Trevon Allen,SO,G,Idaho,Big Sky,31,510,43,117,18,47,25,70,17,25,2,58,60,46,11,2,26,26,128
Idaho8,8,Arkadiy Mkrtychyan,SR,F,Idaho,Big Sky,26,459,63,127,62,119,1,8,39,56,29,64,93,26,8,2,36,66,166
Idaho9,9,Scott Blakney,FR,F,Idaho,Big Sky,16,90,7,14,7,14,0,0,2,3,5,9,14,1,0,1,7,18,16
Idaho10,10,Garrett Kingman,FR,G,Idaho,Big Sky,12,56,3,10,2,5,1,5,3,4,9,6,15,2,1,1,2,2,10
Idaho11,11,Geno West,FR,G,Idaho,Big Sky,10,44,3,12,2,5,1,7,5,6,2,2,4,5,0,0,1,6,12
Idaho12,12,Chance Garvin,FR,G,Idaho,Big Sky,7,13,1,2,1,2,0,0,0,0,0,2,2,0,0,0,1,1,2
Idaho State1,1,Geno Luzcando,SR,G,Idaho State,Big Sky,30,952,108,219,94,173,14,46,96,140,27,115,142,87,59,8,87,109,326
Idaho State2,2,Jared Stutzman,SO,G,Idaho State,Big Sky,27,889,135,238,69,111,66,127,67,93,9,84,93,41,17,7,34,47,403
Idaho State3,3,Brandon Boyd,SO,G,Idaho State,Big Sky,29,858,148,316,104,186,44,130,93,116,15,108,123,71,39,2,56,48,433
Idaho State4,4,Balint Mocsan,SO,G,Idaho State,Big Sky,30,844,108,240,46,92,62,148,25,39,10,95,105,31,20,8,47,62,303
Idaho State5,5,Novak Topalovic,JR,C,Idaho State,Big Sky,30,814,131,248,131,246,0,2,59,107,53,150,203,36,8,32,89,92,321
Idaho State6,6,Gary Chivichyan,SO,G,Idaho State,Big Sky,21,331,49,113,14,34,35,79,13,21,3,26,29,5,3,3,8,25,146
Idaho State7,7,Blake Truman,JR,F,Idaho State,Big Sky,28,280,22,62,13,32,9,30,6,8,18,35,53,11,6,0,20,35,59
Idaho State8,8,Kyle Ingram,SR,F,Idaho State,Big Sky,12,277,21,45,21,45,0,0,6,9,13,33,46,29,3,10,9,31,48
Idaho State9,9,Sam Dowd,,G,Idaho State,Big Sky,29,271,16,41,11,24,5,17,19,29,5,13,18,25,5,0,24,17,56
Idaho State10,10,Erik Nakken,SR,G,Idaho State,Big Sky,28,243,13,40,0,4,13,36,2,3,2,14,16,8,1,1,6,17,41
Idaho State11,11,Jacob McCord,JR,F,Idaho State,Big Sky,18,139,21,57,19,47,2,10,13,20,20,28,48,4,4,1,18,19,57
Idaho State12,12,Hayes Garrity,,G,Idaho State,Big Sky,11,43,3,8,1,1,2,7,0,0,0,5,5,4,0,0,5,8,8
Idaho State13,13,Lyle Sutton,FR,G,Idaho State,Big Sky,15,35,2,9,2,4,0,5,4,8,1,1,2,2,2,0,2,11,8
Idaho State14,14,Callum Kimberley,,F,Idaho State,Big Sky,7,18,0,1,0,1,0,0,0,1,1,0,1,0,2,0,2,3,0
Idaho State15,15,Houston Wahlen,FR,G,Idaho State,Big Sky,5,6,1,2,1,2,0,0,0,0,0,1,1,0,0,0,0,1,2
Illinois1,1,Trent Frazier,FR,G,Illinois,Big Ten,32,842,140,346,79,170,61,176,58,90,7,49,56,99,54,1,71,68,399
Illinois2,2,Leron Black,JR,F,Illinois,Big Ten,31,789,188,344,166,301,22,43,76,95,55,106,161,26,10,8,56,104,474
Illinois3,3,Mark Alstork,SR,G,Illinois,Big Ten,32,724,56,167,37,88,19,79,55,72,42,67,109,59,26,13,44,83,186
Illinois4,4,Michael Finke,JR,F,Illinois,Big Ten,28,699,107,218,78,124,29,94,30,49,52,78,130,30,9,8,22,56,273
Illinois5,5,Aaron Jordan,JR,G,Illinois,Big Ten,32,644,77,165,33,70,44,95,54,64,42,57,99,23,27,7,30,63,252
Illinois6,6,Te'Jon Lucas,,G,Illinois,Big Ten,29,620,64,134,59,115,5,19,32,52,12,53,65,94,31,3,56,74,165
Illinois7,7,Mark Smith,FR,G,Illinois,Big Ten,31,591,60,178,44,109,16,69,43,54,18,24,42,42,18,2,39,77,179
Illinois8,8,Kipper Nichols,SO,F,Illinois,Big Ten,31,590,99,226,68,144,31,82,81,94,44,85,129,23,25,11,36,71,310
Illinois9,9,De'Monte Williams,,G,Illinois,Big Ten,31,523,35,104,26,64,9,40,31,44,31,58,89,33,23,4,28,43,110
Illinois10,10,Greg Eboigbodin,FR,F,Illinois,Big Ten,30,318,27,49,27,49,0,0,11,25,33,40,73,8,11,11,16,63,65
Illinois11,11,Matic Vesel,FR,F,Illinois,Big Ten,16,70,2,7,2,7,0,0,3,8,1,7,8,5,0,1,5,13,7
Illinois12,12,Drew Cayce,SO,G,Illinois,Big Ten,9,34,0,8,0,1,0,7,4,6,1,3,4,0,4,0,1,1,4
Illinois13,13,Cameron Liss,JR,F,Illinois,Big Ten,8,16,1,2,1,2,0,0,0,0,0,0,0,0,1,0,0,3,2
Illinois14,14,Samson Oladimeji,SO,G,Illinois,Big Ten,7,15,0,1,0,0,0,1,0,0,1,3,4,0,1,0,0,1,0
Illinois State1,1,Keyshawn Evans,JR,G,Illinois State,MVC,30,935,140,341,49,124,91,217,85,112,10,70,80,108,19,0,62,58,456
Illinois State2,2,Milik Yarbrough,JR,F,Illinois State,MVC,32,895,172,380,141,273,31,107,156,194,46,164,210,152,30,21,126,85,531
Illinois State3,3,William Tinsley,JR,G,Illinois State,MVC,33,871,72,199,25,51,47,148,7,14,27,151,178,31,19,35,28,72,198
Illinois State4,4,Phil Fayne,JR,F,Illinois State,MVC,29,866,181,304,181,304,0,0,89,173,99,117,216,27,35,28,51,82,451
Illinois State5,5,Madison Williams,SO,G,Illinois State,MVC,31,754,56,175,18,57,38,118,13,17,9,67,76,43,33,10,40,87,163
Illinois State6,6,Matt Hein,SO,G,Illinois State,MVC,32,701,39,128,13,45,26,83,24,37,12,57,69,32,27,3,50,81,128
Illinois State7,7,Taylor Bruninga,FR,F,Illinois State,MVC,29,506,47,121,12,21,35,100,15,21,15,54,69,12,5,6,11,85,144
Illinois State8,8,Isaac Gassman,FR,G,Illinois State,MVC,32,470,44,102,19,38,25,64,8,15,18,41,59,16,19,2,14,39,121
Illinois State9,9,Daouda Ndiaye,,C,Illinois State,MVC,20,361,35,66,35,65,0,1,15,22,27,52,79,8,11,25,11,45,85
Illinois State10,10,Elijah Clarance,FR,G,Illinois State,MVC,21,233,16,66,14,43,2,23,22,31,3,19,22,27,10,1,32,29,56
Illinois State11,11,Jerron Martin,SR,G,Illinois State,MVC,10,110,7,28,4,11,3,17,3,4,1,6,7,11,6,0,7,6,20
Illinois State12,12,Luke Litwiller,,F,Illinois State,MVC,9,48,4,7,1,1,3,6,0,0,1,3,4,1,2,0,1,8,11
Illinois-Chicago1,1,Dikembe Dixson,SO,F,Illinois-Chicago,Horizon,32,950,149,383,114,272,35,111,120,164,22,89,111,26,40,6,89,58,453
Illinois-Chicago2,2,Marcus Ottey,SO,G,Illinois-Chicago,Horizon,32,884,158,301,134,237,24,64,92,110,18,90,108,58,27,15,63,68,432
Illinois-Chicago3,3,Jordan Blount,SO,F,Illinois-Chicago,Horizon,32,815,85,183,71,123,14,60,30,45,51,170,221,77,33,16,90,112,214
Illinois-Chicago4,4,Tai Odiase,SR,C,Illinois-Chicago,Horizon,32,814,113,204,113,204,0,0,71,111,76,108,184,8,23,102,34,67,297
Illinois-Chicago5,5,Godwin Boahen,SO,G,Illinois-Chicago,Horizon,30,665,85,194,41,91,44,103,39,50,11,78,89,61,31,4,46,77,253
Illinois-Chicago6,6,Tarkus Ferguson,SO,G,Illinois-Chicago,Horizon,23,651,75,192,46,105,29,87,45,59,15,99,114,123,25,22,55,49,224
Illinois-Chicago7,7,Dominique Matthews,SO,G,Illinois-Chicago,Horizon,32,628,90,253,40,105,50,148,42,59,17,41,58,24,18,9,39,43,272
Illinois-Chicago8,8,Clint Robinson,SR,C,Illinois-Chicago,Horizon,30,449,40,65,40,62,0,3,48,63,47,71,118,5,8,34,28,72,128
Illinois-Chicago9,9,Michael Diggins,FR,F,Illinois-Chicago,Horizon,32,379,33,60,19,32,14,28,13,20,17,62,79,18,9,8,22,36,93
Illinois-Chicago10,10,Jacob Wiley,FR,F,Illinois-Chicago,Horizon,22,165,14,30,13,25,1,5,5,12,6,28,34,7,3,5,6,26,34
Illinois-Chicago11,11,Naradain James,JR,F,Illinois-Chicago,Horizon,3,25,1,9,1,5,0,4,1,2,2,2,4,0,1,3,1,1,3
Incarnate Word1,1,Shawn Johnson,SR,G,Incarnate Word,Southland,28,898,106,261,48,100,58,161,70,99,30,159,189,52,41,44,41,67,340
Incarnate Word2,2,Charles Brown III,JR,PF,Incarnate Word,Southland,26,791,127,269,107,227,20,42,77,96,40,95,135,31,22,7,69,55,351
Incarnate Word3,3,Sam Burmeister,SR,G,Incarnate Word,Southland,26,610,70,159,44,89,26,70,34,51,3,70,73,26,18,3,37,58,200
Incarnate Word4,4,Keaton Hervey,FR,G,Incarnate Word,Southland,25,587,60,160,49,121,11,39,70,90,19,39,58,29,11,6,40,46,201
Incarnate Word5,5,Cody Graham,FR,PG,Incarnate Word,Southland,24,468,42,102,35,68,7,34,16,25,13,23,36,59,13,1,38,29,107
Incarnate Word6,6,Christian Peevy,FR,SF,Incarnate Word,Southland,28,444,71,133,70,127,1,6,74,90,36,65,101,14,11,11,46,64,217
Incarnate Word7,7,Simi Socks,JR,PF,Incarnate Word,Southland,25,436,67,149,58,121,9,28,59,74,37,48,85,11,10,10,54,60,202
Incarnate Word8,8,Jalin Hart,SR,PG,Incarnate Word,Southland,11,312,32,94,23,61,9,33,19,31,5,21,26,43,14,5,37,23,92
Incarnate Word9,9,Augustine Ene,FR,G,Incarnate Word,Southland,25,312,33,86,26,62,7,24,25,31,15,29,44,23,17,7,29,30,98
Incarnate Word10,10,Jorden Kite,SO,SG,Incarnate Word,Southland,23,280,24,62,6,10,18,52,7,9,1,26,27,15,6,0,15,26,73
Incarnate Word11,11,Devin Wyatt,SR,C,Incarnate Word,Southland,21,248,15,38,15,37,0,1,11,22,21,22,43,2,5,30,9,38,41
Incarnate Word12,12,Konstantin Kulikov,,C,Incarnate Word,Southland,14,190,24,52,24,50,0,2,7,11,16,31,47,6,2,18,19,22,55
Incarnate Word13,13,Myles Thornton,JR,PF,Incarnate Word,Southland,14,24,0,1,0,0,0,1,1,2,0,2,2,0,0,1,1,3,1
Indiana1,1,Robert Johnson,SR,G,Indiana,Big Ten,31,1060,156,365,90,188,66,177,57,81,6,133,139,84,24,6,76,64,435
Indiana2,2,Juwan Morgan,JR,F,Indiana,Big Ten,31,912,195,337,179,284,16,53,106,168,84,144,228,47,37,44,51,77,512
Indiana3,3,Josh Newkirk,SR,G,Indiana,Big Ten,31,721,73,193,44,98,29,95,46,57,12,53,65,86,15,8,57,56,221
Indiana4,4,Devonte Green,SO,G,Indiana,Big Ten,31,697,80,220,47,122,33,98,43,61,9,51,60,76,32,6,59,33,236
Indiana5,5,Zach McRoberts,JR,G,Indiana,Big Ten,28,613,27,63,14,30,13,33,11,16,35,60,95,33,37,4,18,66,78
Indiana6,6,Aljami Durham,FR,G,Indiana,Big Ten,31,583,47,115,33,66,14,49,40,56,5,54,59,39,11,4,25,57,148
Indiana7,7,Justin Smith,FR,F,Indiana,Big Ten,31,463,82,149,79,139,3,10,33,49,43,55,98,7,7,10,34,58,200
Indiana8,8,Freddie McSwain,SR,F,Indiana,Big Ten,31,453,45,101,45,100,0,1,40,70,60,80,140,16,10,18,28,59,130
Indiana9,9,Collin Hartman,SR,F,Indiana,Big Ten,23,354,35,95,19,29,16,66,11,16,19,43,62,23,9,4,11,44,97
Indiana10,10,De'Ron Davis,,F,Indiana,Big Ten,15,282,56,91,56,91,0,0,32,64,27,37,64,16,12,22,12,37,144
Indiana11,11,Curtis Jones,SO,G,Indiana,Big Ten,7,80,7,26,3,8,4,18,3,4,1,8,9,3,3,2,2,2,21
Indiana12,12,Clifton Moore,FR,F,Indiana,Big Ten,9,43,3,12,3,10,0,2,0,0,2,6,8,2,1,6,2,6,6
Indiana13,13,Johnny Jager,,G,Indiana,Big Ten,6,7,0,0,0,0,0,0,0,0,0,0,0,2,0,0,0,1,0
Indiana14,14,Tim Priller,,F,Indiana,Big Ten,4,4,0,0,0,0,0,0,1,2,0,2,2,0,0,0,0,1,1
Indiana15,15,Quentin Taylor,,G,Indiana,Big Ten,1,2,0,0,0,0,0,0,0,0,0,0,0,1,0,0,0,0,0
Indiana16,16,Ethan Lasko,,G,Indiana,Big Ten,1,1,0,0,0,0,0,0,0,0,0,0,0,0,0,0,0,0,0
Indiana State1,1,Jordan Barnes,SO,G,Indiana State,MVC,31,1044,168,405,51,128,117,277,87,102,10,111,121,113,37,2,86,78,540
Indiana State2,2,Brenton Scott,SR,G,Indiana State,MVC,31,1018,156,390,94,206,62,184,75,105,14,163,177,73,53,6,78,78,449
Indiana State3,3,Tyreke Key,FR,G,Indiana State,MVC,30,843,82,228,59,157,23,71,63,88,25,102,127,45,29,8,43,61,250
Indiana State4,4,Qiydar Davis,SR,G,Indiana State,MVC,29,768,111,236,83,156,28,80,59,76,37,101,138,30,47,18,48,87,309
Indiana State5,5,Brandon Murphy,SR,C,Indiana State,MVC,31,647,81,134,81,134,0,0,73,114,81,74,155,25,15,18,49,73,235
Indiana State6,6,Clayton Hughes,FR,G,Indiana State,MVC,29,481,36,78,22,33,14,45,15,20,9,25,34,25,15,5,34,46,101
Indiana State7,7,Emondre Rickman,JR,C,Indiana State,MVC,29,387,43,95,43,95,0,0,24,50,34,69,103,9,8,28,32,51,110
Indiana State8,8,Bronson Kessinger,SO,F,Indiana State,MVC,29,351,35,82,31,62,4,20,12,22,26,39,65,11,9,7,12,40,86
Indiana State9,9,Devin Thomas,JR,F,Indiana State,MVC,25,318,23,67,14,40,9,27,30,40,24,43,67,12,6,10,26,33,85
Indiana State10,10,Demonte Ojinnaka,SR,G,Indiana State,MVC,27,282,17,60,4,21,13,39,2,3,2,21,23,10,2,2,11,32,49
Indiana State11,11,Matt Deady,FR,G,Indiana State,MVC,20,151,8,18,8,17,0,1,8,13,8,12,20,5,10,0,8,22,24
Indiana State12,12,Trey Knight III,SO,G,Indiana State,MVC,9,52,1,2,1,2,0,0,4,7,1,3,4,1,1,1,5,7,6
Indiana State13,13,Ethan Claycomb,FR,F,Indiana State,MVC,7,20,0,4,0,1,0,3,0,0,0,1,1,1,1,0,0,3,0
Indiana State14,14,Daniel Huenermann,FR,C,Indiana State,MVC,7,13,1,4,1,3,0,1,2,4,1,2,3,0,0,0,0,3,4
Iona1,1,Rickey McGill,JR,G,Iona,MAAC,33,1110,160,356,110,226,50,130,77,110,24,112,136,184,52,4,92,69,447
Iona2,2,Deyshonee Much,SR,G,Iona,MAAC,31,897,116,282,49,116,67,166,36,44,23,98,121,73,39,7,46,51,335
Iona3,3,Schadrac Casimir,JR,G,Iona,MAAC,32,868,96,215,33,79,63,136,78,94,14,48,62,59,25,0,36,64,333
Iona4,4,E.J. Crawford,SO,F,Iona,MAAC,32,860,146,311,96,168,50,143,70,88,17,94,111,36,19,9,31,58,412
Iona5,5,Zach Lewis,SR,G,Iona,MAAC,30,836,93,232,48,98,45,134,44,59,4,83,87,91,44,9,42,62,275
Iona6,6,Tarekeyi Edogi,SR,F,Iona,MAAC,33,793,119,210,118,204,1,6,44,58,83,151,234,13,17,38,50,80,283
Iona7,7,Roland Griffin,JR,F,Iona,MAAC,32,757,135,259,133,250,2,9,76,114,38,128,166,46,14,22,49,90,348
Iona8,8,Jan Svandrlik,SR,F,Iona,MAAC,33,327,37,88,7,15,30,73,19,23,21,35,56,9,9,6,4,42,123
Iona9,9,C.J. Seaforth,,G,Iona,MAAC,19,141,15,33,4,8,11,25,3,5,2,11,13,12,2,0,13,21,44
Iona10,10,Gavin Kensmil,FR,F,Iona,MAAC,22,103,10,21,10,21,0,0,3,14,8,14,22,2,3,3,9,29,23
Iona11,11,Tyrell Williams,JR,F,Iona,MAAC,13,31,4,9,4,9,0,0,2,3,4,9,13,0,0,3,3,4,10
Iona12,12,Nils Taylor,,G,Iona,MAAC,2,2,0,0,0,0,0,0,0,0,0,0,0,1,0,0,0,1,0
Iowa1,1,Jordan Bohannon,SO,G,Iowa,Big Ten,33,1050,137,324,41,101,96,223,75,83,4,70,74,178,22,0,68,59,445
Iowa2,2,Tyler Cook,SO,F,Iowa,Big Ten,33,923,192,339,191,332,1,7,121,184,72,152,224,57,21,19,82,87,506
Iowa3,3,Isaiah Moss,SO,G,Iowa,Big Ten,33,798,129,307,80,180,49,127,58,66,17,57,74,63,22,7,41,46,365
Iowa4,4,Luka Garza,FR,F,Iowa,Big Ten,33,715,146,262,130,216,16,46,92,135,79,132,211,35,11,32,35,80,400
Iowa5,5,Nicholas Baer,JR,F,Iowa,Big Ten,27,578,53,133,30,58,23,75,13,22,51,83,134,49,27,23,29,54,142
Iowa6,6,Maishe Dailey,SO,G,Iowa,Big Ten,33,544,58,136,30,64,28,72,19,33,6,58,64,52,10,2,29,23,163
Iowa7,7,Cordell Pemsl,SO,F,Iowa,Big Ten,32,525,65,114,65,114,0,0,51,76,37,107,144,47,7,10,45,53,181
Iowa8,8,Jack Nunge,FR,F,Iowa,Big Ten,33,517,66,149,47,92,19,57,37,48,35,56,91,34,21,25,32,38,188
Iowa9,9,Brady Ellingson,JR,G,Iowa,Big Ten,26,285,28,68,13,30,15,38,2,5,0,17,17,28,7,2,15,8,73
Iowa10,10,Ryan Kriener,SO,F,Iowa,Big Ten,27,280,43,78,41,68,2,10,8,21,19,33,52,26,13,7,20,48,96
Iowa11,11,Ahmad Wagner,JR,F,Iowa,Big Ten,30,272,21,42,19,36,2,6,6,18,25,26,51,18,7,2,18,41,50
Iowa12,12,Dom Uhl,SR,F,Iowa,Big Ten,16,73,2,9,2,7,0,2,1,4,4,14,18,6,0,4,8,6,5
Iowa13,13,Connor McCaffery,,G,Iowa,Big Ten,4,53,2,3,1,1,1,2,3,4,0,4,4,7,2,0,4,2,8
Iowa14,14,Riley Till,FR,F,Iowa,Big Ten,8,23,1,5,1,1,0,4,0,0,0,1,1,0,2,0,1,2,2
Iowa15,15,Charlie Rose,SR,F,Iowa,Big Ten,8,14,3,6,3,3,0,3,0,0,1,2,3,2,0,0,2,1,6
Iowa State1,1,Donovan Jackson,SR,G,Iowa State,Big 12,30,1032,143,375,48,138,95,237,70,80,8,55,63,62,15,2,48,62,451
Iowa State2,2,Lindell Wigginton,FR,G,Iowa State,Big 12,31,1022,171,413,102,241,69,172,107,162,20,96,116,88,28,13,92,78,518
Iowa State3,3,Nick Weiler-Babb,JR,G,Iowa State,Big 12,22,791,84,188,64,126,20,62,60,79,15,138,153,149,28,8,55,37,248
Iowa State4,4,Cameron Lard,FR,F,Iowa State,Big 12,29,767,161,268,161,268,0,0,43,73,98,136,234,17,15,63,54,81,365
Iowa State5,5,Solomon Young,SO,F,Iowa State,Big 12,26,708,71,146,68,127,3,19,43,60,51,103,154,18,22,19,24,76,188
Iowa State6,6,Zoran Talley,JR,F,Iowa State,Big 12,23,616,74,164,67,139,7,25,18,31,21,71,92,40,12,6,25,32,173
Iowa State7,7,Jeff Beverly,SR,F,Iowa State,Big 12,28,484,51,117,42,79,9,38,20,29,41,42,83,15,12,3,24,56,131
Iowa State8,8,Hans Brase,SR,F,Iowa State,Big 12,21,324,16,54,11,34,5,20,13,17,15,65,80,12,4,8,15,26,50
Iowa State9,9,Terrence Lewis,FR,G,Iowa State,Big 12,27,297,32,105,15,46,17,59,12,18,16,20,36,9,9,7,14,34,93
Iowa State10,10,Jakolby Long,SO,G,Iowa State,Big 12,22,209,14,40,5,19,9,21,4,8,5,24,29,13,4,0,8,26,41
IPFW1,1,John Konchar,JR,G,IPFW,Summit,32,1139,173,360,108,192,65,168,70,106,65,195,260,150,80,22,54,59,481
IPFW2,2,Kason Harrell,JR,G,IPFW,Summit,32,993,158,359,71,123,87,236,38,46,21,72,93,45,36,16,60,70,441
IPFW3,3,Bryson Scott,SR,G,IPFW,Summit,32,990,236,526,188,361,48,165,198,241,20,127,147,86,64,4,89,62,718
IPFW4,4,Jax Levitch,SO,G,IPFW,Summit,32,852,52,124,8,21,44,103,22,35,24,109,133,34,29,7,20,54,170
IPFW5,5,Xzavier Taylor,SR,F,IPFW,Summit,32,669,98,177,93,165,5,12,39,71,58,80,138,29,4,22,42,90,240
IPFW6,6,Matt Weir,FR,G,IPFW,Summit,32,654,46,122,13,40,33,82,36,41,4,39,43,84,14,0,41,37,161
IPFW7,7,Dylan Carl,FR,F,IPFW,Summit,31,450,57,128,43,91,14,37,17,33,33,59,92,20,6,27,27,54,145
IPFW8,8,Jordon King,SR,G,IPFW,Summit,32,354,60,129,31,56,29,73,21,43,8,45,53,9,18,3,26,43,170
IPFW9,9,Cameron Benford,FR,F,IPFW,Summit,25,159,10,24,10,24,0,0,4,7,20,30,50,5,4,3,9,43,24
IPFW10,10,Jarius Stevens,FR,G,IPFW,Summit,13,86,14,35,13,26,1,9,10,10,10,11,21,2,3,0,4,3,39
IPFW11,11,Chris Rollins,FR,G,IPFW,Summit,12,54,12,23,11,16,1,7,1,2,3,2,5,5,2,0,3,3,26
IPFW12,12,Jordan Coblin,FR,G,IPFW,Summit,7,25,4,7,3,5,1,2,3,3,0,2,2,2,1,0,2,6,12
IUPUI1,1,Ron Patterson,SR,G,IUPUI,Horizon,30,837,111,275,49,105,62,170,25,38,16,79,95,54,33,20,49,66,309
IUPUI2,2,Aaron Brennan,SR,F,IUPUI,Horizon,30,818,140,302,111,218,29,84,63,79,38,97,135,48,31,19,53,78,372
IUPUI3,3,D.J. McCall,JR,G,IUPUI,Horizon,29,799,70,173,60,133,10,40,53,74,48,73,121,57,43,11,41,67,203
IUPUI4,4,T.J. Henderson,JR,G,IUPUI,Horizon,30,721,102,245,62,133,40,112,80,96,17,62,79,63,30,6,73,56,324
IUPUI5,5,Evan Hall,JR,F,IUPUI,Horizon,29,655,97,215,97,215,0,0,30,102,74,104,178,20,21,25,54,79,224
IUPUI6,6,Nick Rogers,SO,G,IUPUI,Horizon,27,635,40,120,23,71,17,49,40,56,8,35,43,81,12,1,56,54,137
IUPUI7,7,Jaylen Minnett,FR,G,IUPUI,Horizon,30,630,69,173,18,47,51,126,24,30,12,24,36,35,14,1,39,42,213
IUPUI8,8,Maurice Kirby,SR,F,IUPUI,Horizon,30,451,56,114,56,113,0,1,24,40,39,78,117,13,9,8,28,62,136
IUPUI9,9,Elyjah Goss,FR,F,IUPUI,Horizon,30,414,41,93,37,80,4,13,22,29,38,68,106,12,12,11,20,46,108
IUPUI10,10,Evan Borgman,FR,F,IUPUI,Horizon,9,30,2,6,2,4,0,2,4,6,2,4,6,0,0,0,3,2,8
IUPUI11,11,Chad Hudson,SO,G,IUPUI,Horizon,8,27,2,6,2,3,0,3,5,7,0,1,1,2,0,0,2,7,9
IUPUI12,12,Noah Thomas,SO,C,IUPUI,Horizon,2,8,1,1,1,1,0,0,2,2,1,3,4,0,0,1,0,3,4
Jackson State1,1,Julian Daughtry,,G,Jackson State,SWAC,32,807,65,176,34,92,31,84,44,62,26,42,68,39,30,4,32,65,205
Jackson State2,2,Jeremiah Jefferson,,G,Jackson State,SWAC,30,790,102,295,39,111,63,184,23,29,11,40,51,36,12,3,25,45,290
Jackson State3,3,Paris Collins,SR,G,Jackson State,SWAC,25,728,106,299,71,175,35,124,34,56,53,99,152,63,73,13,44,64,281
Jackson State4,4,Maurice Rivers,SR,F,Jackson State,SWAC,29,716,135,342,121,294,14,48,87,125,55,100,155,31,21,25,53,95,371
Jackson State5,5,Darius Austin,SR,F,Jackson State,SWAC,30,656,70,187,46,120,24,67,26,51,37,76,113,35,28,7,50,65,190
Jackson State6,6,Jesse Love,FR,G,Jackson State,SWAC,31,578,28,69,16,37,12,32,7,15,16,30,46,26,8,3,16,35,75
Jackson State7,7,Jeremiah Bozeman,SO,G,Jackson State,SWAC,31,507,23,54,18,41,5,13,32,43,22,33,55,20,17,1,24,54,83
Jackson State8,8,Treshawn Bolden,,F,Jackson State,SWAC,22,457,56,142,48,117,8,25,21,38,41,80,121,45,7,13,54,66,141
Jackson State9,9,Lemmie Howard,,G,Jackson State,SWAC,28,362,43,95,33,63,10,32,6,10,27,49,76,7,9,8,13,53,102
Jackson State10,10,Chace Franklin,SR,G,Jackson State,SWAC,11,266,37,110,23,59,14,51,24,34,12,28,40,24,10,3,8,25,112
Jackson State11,11,Jordan Berry,SO,G,Jackson State,SWAC,23,207,19,68,3,15,16,53,3,4,7,13,20,7,7,0,10,16,57
Jackson State12,12,Charles Taylor,SR,G,Jackson State,SWAC,11,137,7,24,7,24,0,0,5,6,8,20,28,5,9,3,12,21,19
Jackson State13,13,Demetrice Clopton,SO,C,Jackson State,SWAC,17,110,13,34,13,34,0,0,6,10,15,18,33,4,2,0,8,23,32
Jackson State14,14,Payton Wilson,,G,Jackson State,SWAC,12,88,8,18,4,12,4,6,5,10,8,9,17,2,2,4,9,12,25
Jackson State15,15,Dontelius Ross,,G,Jackson State,SWAC,3,44,2,8,0,3,2,5,2,4,0,0,0,6,0,0,3,5,8
Jackson State16,16,James Glenn,,F,Jackson State,SWAC,8,21,0,1,0,1,0,0,0,0,1,3,4,1,0,2,2,7,0
Jackson State17,17,Tyler Berryhill,,G,Jackson State,SWAC,1,1,0,0,0,0,0,0,0,0,0,0,0,0,0,0,0,0,0
Jacksonville1,1,Devin Harris,SR,G,Jacksonville,A-Sun,29,974,121,268,112,234,9,34,112,152,33,188,221,158,49,5,97,51,363
Jacksonville2,2,Cody Helgeland,SR,F,Jacksonville,A-Sun,33,970,90,239,28,61,62,178,26,34,25,80,105,34,18,14,48,68,268
Jacksonville3,3,JD Notae,FR,G,Jacksonville,A-Sun,28,878,159,388,110,267,49,121,65,92,28,103,131,54,49,14,72,60,432
Jacksonville4,4,Tanner Rubio,SO,G,Jacksonville,A-Sun,33,838,86,260,29,73,57,187,25,41,11,35,46,54,19,1,59,56,254
Jacksonville5,5,Jace Hogan,JR,F,Jacksonville,A-Sun,27,828,194,376,191,367,3,9,72,105,62,117,179,32,22,14,51,61,463
Jacksonville6,6,Jalyn Hinton,FR,G,Jacksonville,A-Sun,32,755,119,180,119,180,0,0,50,89,58,112,170,16,22,35,23,66,288
Jacksonville7,7,Antwon Clayton,,F,Jacksonville,A-Sun,17,404,33,65,30,55,3,10,16,37,22,60,82,27,14,20,32,41,85
Jacksonville8,8,Radwan Bakkali,JR,C,Jacksonville,A-Sun,28,296,35,82,33,77,2,5,22,28,23,44,67,11,3,3,34,41,94
Jacksonville9,9,Damien Sears,FR,F,Jacksonville,A-Sun,16,260,30,53,30,52,0,1,5,22,20,38,58,6,14,6,14,42,65
Jacksonville10,10,Corey Romich,FR,G,Jacksonville,A-Sun,22,256,13,42,1,3,12,39,2,3,4,7,11,12,6,0,7,17,40
Jacksonville11,11,Derrick Flowers,FR,F,Jacksonville,A-Sun,15,142,5,18,2,8,3,10,3,5,6,12,18,2,2,0,8,15,16
Jacksonville12,12,Lee Richmond,SO,G,Jacksonville,A-Sun,15,124,12,22,10,15,2,7,11,13,2,13,15,9,8,0,10,18,37
Jacksonville State1,1,Malcolm Drumwright,SR,G,Jacksonville State,OVC,33,1116,142,361,79,183,63,178,65,79,13,66,79,120,20,2,42,67,412
Jacksonville State2,2,Norbertas Giga,SR,F,Jacksonville State,OVC,33,820,105,253,89,197,16,56,47,66,62,141,203,55,13,21,57,66,273
Jacksonville State3,3,Marlon Hunter,JR,G,Jacksonville State,OVC,32,800,142,280,131,241,11,39,43,54,55,56,111,36,33,3,34,58,338
Jacksonville State4,4,Jason Burnell,JR,F,Jacksonville State,OVC,32,787,133,257,107,183,26,74,58,77,59,131,190,54,25,34,45,88,350
Jacksonville State5,5,Jamall Gregory,JR,G,Jacksonville State,OVC,33,784,108,238,85,163,23,75,53,81,19,98,117,104,51,33,81,69,292
Jacksonville State6,6,Christian Cunningham,JR,F,Jacksonville State,OVC,32,756,106,160,106,160,0,0,33,69,82,142,224,15,23,56,44,87,245
Jacksonville State7,7,Ashton Spears,SO,G,Jacksonville State,OVC,31,406,30,81,15,35,15,46,45,57,11,48,59,32,13,1,20,36,120
Jacksonville State8,8,Tyrik Edwards,SO,G,Jacksonville State,OVC,31,329,21,56,19,48,2,8,19,31,8,40,48,31,7,4,25,11,63
Jacksonville State9,9,Maurice Dunlap,JR,G,Jacksonville State,OVC,29,304,26,82,5,16,21,66,10,13,0,28,28,29,5,0,10,13,83
Jacksonville State10,10,Cam Martin,FR,F,Jacksonville State,OVC,28,273,38,74,27,48,11,26,28,45,17,56,73,20,3,4,21,48,115
Jacksonville State11,11,Jacara Cross,SO,F,Jacksonville State,OVC,24,145,21,38,21,38,0,0,3,11,10,24,34,9,3,9,18,28,45
Jacksonville State12,12,Des Curry,SR,G,Jacksonville State,OVC,15,51,3,11,3,7,0,4,1,2,0,0,0,2,1,0,2,0,7
Jacksonville State13,13,Mohamed Abuarisha,SO,G,Jacksonville State,OVC,14,46,4,19,1,7,3,12,0,0,2,5,7,3,1,0,7,3,11
Jacksonville State14,14,Deon Wright,,G,Jacksonville State,OVC,6,8,0,0,0,0,0,0,5,6,0,0,0,0,0,0,0,1,5
James Madison1,1,Stuckey Mosley,JR,G,James Madison,CAA,32,1140,199,482,114,251,85,231,107,127,24,119,143,68,46,7,63,80,590
James Madison2,2,Matt Lewis,FR,G,James Madison,CAA,32,1017,136,362,82,201,54,161,137,171,24,95,119,72,31,5,40,62,463
James Madison3,3,Darius Banks,FR,G,James Madison,CAA,32,941,115,282,88,186,27,96,69,84,29,104,133,59,48,13,61,84,326
James Madison4,4,Ramone Snowden,SR,F,James Madison,CAA,32,927,66,152,35,75,31,77,40,71,30,94,124,84,41,9,54,107,203
James Madison5,5,Develle Phillips,JR,F,James Madison,CAA,32,735,117,197,117,197,0,0,46,87,74,126,200,29,11,38,51,113,280
James Madison6,6,Joey McLean,SR,G,James Madison,CAA,25,624,73,192,52,117,21,75,38,46,8,33,41,52,23,4,38,62,205
James Madison7,7,Zach Jacobs,FR,F,James Madison,CAA,32,409,38,92,30,61,8,31,13,18,40,59,99,9,5,9,13,56,97
James Madison8,8,Greg Jones,FR,F,James Madison,CAA,31,324,20,64,17,47,3,17,12,19,35,35,70,4,11,13,23,46,55
James Madison9,9,Dwight Wilson,FR,F,James Madison,CAA,26,237,34,74,34,74,0,0,11,19,33,55,88,1,4,3,18,35,79
James Madison10,10,Cameron Smith,SR,F,James Madison,CAA,6,67,5,10,5,10,0,0,3,5,4,8,12,4,5,1,4,9,13
James Madison11,11,Gerron Scissum,SO,F,James Madison,CAA,7,65,5,12,3,6,2,6,5,7,7,10,17,3,2,2,3,7,17
James Madison12,12,Antanee Pinkard,SO,G,James Madison,CAA,9,62,4,13,4,12,0,1,4,11,5,5,10,3,1,0,5,9,12
James Madison13,13,Alex Schulz,FR,F,James Madison,CAA,1,2,0,0,0,0,0,0,1,2,2,1,3,0,0,0,0,0,1
Kansas1,1,Devonte' Graham,,G,Kansas,Big 12,34,1277,172,427,74,189,98,238,146,175,17,117,134,254,55,2,94,50,588
Kansas2,2,Sviatoslav Mykhailiuk,SR,G,Kansas,Big 12,34,1168,185,419,79,185,106,234,38,48,39,98,137,89,38,9,58,84,514
Kansas3,3,Lagerald Vick,JR,G,Kansas,Big 12,34,1115,163,333,114,198,49,135,33,50,33,135,168,79,31,10,58,67,408
Kansas4,4,Malik Newman,SO,G,Kansas,Big 12,34,1047,153,332,83,161,70,171,69,85,15,150,165,72,36,6,49,51,445
Kansas5,5,Udoka Azubuike,SO,C,Kansas,Big 12,31,753,192,248,192,248,0,0,42,100,77,143,220,19,16,55,55,91,426
Kansas6,6,Marcus Garrett,FR,G,Kansas,Big 12,34,671,59,122,47,79,12,43,21,42,32,87,119,40,34,7,25,52,151
Kansas7,7,Mitch Lightfoot,SO,F,Kansas,Big 12,34,486,55,97,49,80,6,17,15,20,45,57,102,9,10,50,28,76,131
Kansas8,8,Silvio De Sousa,,F,Kansas,Big 12,15,112,23,32,23,32,0,0,9,13,24,23,47,3,1,1,12,23,55
Kansas9,9,Sam Cunliffe,,G,Kansas,Big 12,13,71,12,25,10,17,2,8,2,2,2,6,8,4,2,1,5,11,28
Kansas10,10,Clay Young,SR,G,Kansas,Big 12,11,70,4,10,4,7,0,3,1,2,0,1,1,8,2,1,2,9,9
Kansas11,11,Chris Teahan,FR,G,Kansas,Big 12,9,23,4,11,2,3,2,8,2,2,2,4,6,1,0,0,3,2,12
Kansas12,12,James Sosinski,,F,Kansas,Big 12,5,7,2,2,2,2,0,0,0,0,1,3,4,0,0,0,0,3,4
Kansas State1,1,Barry Brown,JR,G,Kansas State,Big 12,33,1132,183,394,143,273,40,121,121,158,19,84,103,112,60,3,82,71,527
Kansas State2,2,Dean Wade,JR,F,Kansas State,Big 12,32,1075,197,358,157,267,40,91,95,128,42,159,201,89,49,27,47,63,529
Kansas State3,3,Xavier Sneed,SO,F,Kansas State,Big 12,33,1024,121,297,67,130,54,167,61,78,36,124,160,60,52,11,36,75,357
Kansas State4,4,Cartier Diarra,FR,G,Kansas State,Big 12,33,776,82,169,52,94,30,75,43,55,19,55,74,68,23,2,65,74,237
Kansas State5,5,Kamau Stokes,JR,G,Kansas State,Big 12,26,670,72,196,34,85,38,111,54,70,7,52,59,91,28,0,48,33,236
Kansas State6,6,Makol Mawien,SO,F,Kansas State,Big 12,33,637,97,153,95,144,2,9,37,48,40,74,114,9,12,36,34,102,233
Kansas State7,7,Amaad Wainright,JR,G,Kansas State,Big 12,32,435,34,78,22,42,12,36,9,20,23,50,73,17,19,4,15,43,89
Kansas State8,8,Levi Stockard III,FR,F,Kansas State,Big 12,32,286,25,47,25,47,0,0,11,18,20,37,57,3,5,2,14,60,61
Kansas State9,9,Brian Patrick,SO,G,Kansas State,Big 12,24,202,15,47,5,7,10,40,2,2,5,11,16,10,5,0,6,27,42
Kansas State10,10,Mawdo Sallah,SR,F,Kansas State,Big 12,19,159,15,27,15,27,0,0,7,14,9,31,40,4,2,7,9,26,37
Kansas State11,11,James Love,,F,Kansas State,Big 12,13,67,4,9,4,9,0,0,2,5,1,4,5,0,1,5,1,20,10
Kansas State12,12,Mike McGuirl,,G,Kansas State,Big 12,8,64,4,15,3,8,1,7,4,6,2,6,8,7,0,1,3,5,13
Kansas State13,13,Nigel Shadd,FR,F,Kansas State,Big 12,8,50,3,8,3,8,0,0,3,4,7,9,16,0,0,0,3,7,9
Kansas State14,14,Pierson McAtee,SO,F,Kansas State,Big 12,9,19,2,4,0,1,2,3,2,2,0,2,2,1,0,0,2,1,8
Kansas State15,15,Mason Schoen,SR,G,Kansas State,Big 12,10,18,0,4,0,2,0,2,0,0,0,0,0,1,0,0,1,0,0
Kansas State16,16,Kade Kinnamon,JR,G,Kansas State,Big 12,10,11,0,3,0,0,0,3,0,0,0,0,0,1,0,1,0,0,0
Kennesaw State1,1,Nick Masterson,SR,G,Kennesaw State,A-Sun,30,1092,167,300,94,165,73,135,67,77,22,62,84,97,24,4,44,59,474
Kennesaw State2,2,James Scott,SO,G,Kennesaw State,A-Sun,29,923,188,450,134,291,54,159,72,90,16,52,68,63,50,6,77,66,502
Kennesaw State3,3,Tyler Hooker,SO,G,Kennesaw State,A-Sun,30,782,113,276,97,204,16,72,81,114,10,70,80,78,38,4,71,65,323
Kennesaw State4,4,Jordan Jones,SR,F,Kennesaw State,A-Sun,30,661,82,149,82,148,0,1,29,45,31,111,142,33,20,11,28,76,193
Kennesaw State5,5,Isaac Mbuyamba,SO,F,Kennesaw State,A-Sun,30,534,35,73,35,72,0,1,22,63,62,69,131,8,7,26,19,58,92
Kennesaw State6,6,Kosta Jankovic,JR,F,Kennesaw State,A-Sun,25,525,68,148,60,124,8,24,31,42,23,58,81,37,4,4,32,37,175
Kennesaw State7,7,Kyle Clarke,JR,G,Kennesaw State,A-Sun,29,517,46,118,46,112,0,6,29,46,14,58,72,56,35,3,48,55,121
Kennesaw State8,8,Bryson Lockley,SO,F,Kennesaw State,A-Sun,28,475,33,78,32,74,1,4,36,59,38,56,94,26,11,21,32,65,103
Kennesaw State9,9,Anthony Wilson,,F,Kennesaw State,A-Sun,21,359,51,103,50,97,1,6,36,46,36,69,105,35,21,12,23,47,139
Kennesaw State10,10,Tristan Jarrett,FR,G,Kennesaw State,A-Sun,12,149,21,69,14,39,7,30,8,13,8,19,27,8,4,3,22,10,57
Kennesaw State11,11,Arthur Gray,SR,F,Kennesaw State,A-Sun,3,4,1,3,1,3,0,0,1,2,0,1,1,0,0,0,1,1,3
Kennesaw State12,12,Markus Smith,,G,Kennesaw State,A-Sun,2,3,0,1,0,1,0,0,0,0,0,0,0,1,0,0,1,0,0
Kennesaw State13,13,Isaiah Rose,JR,G,Kennesaw State,A-Sun,1,1,0,0,0,0,0,0,0,0,0,1,1,0,0,0,0,0,0
Kent State1,1,Jalen Avery,JR,G,Kent State,MAC,34,1141,119,275,64,128,55,147,58,75,20,73,93,121,21,1,24,31,351
Kent State2,2,Jaylin Walker,JR,G,Kent State,MAC,31,1043,171,450,87,194,84,256,87,111,37,83,120,62,32,4,80,49,513
Kent State3,3,Kevin Zabo,SR,G,Kent State,MAC,34,980,155,368,111,231,44,137,85,108,19,89,108,82,36,2,63,97,439
Kent State4,4,Adonis De La Rosa,,C,Kent State,MAC,34,874,137,242,137,242,0,0,128,163,101,156,257,35,21,22,112,122,402
Kent State5,5,Danny Pippen,SO,F,Kent State,MAC,33,721,90,220,57,127,33,93,53,66,74,149,223,19,13,53,48,97,266
Kent State6,6,Mitch Peterson,SO,G,Kent State,MAC,33,629,43,124,27,62,16,62,12,22,27,82,109,22,24,3,20,41,114
Kent State7,7,B.J. Duling,FR,F,Kent State,MAC,34,540,65,164,53,125,12,39,22,50,22,67,89,17,15,21,27,75,164
Kent State8,8,Desmond Ridenour,SR,G,Kent State,MAC,34,528,53,119,44,86,9,33,17,32,17,52,69,20,26,7,31,61,132
Kent State9,9,Akiean Frederick,JR,F,Kent State,MAC,26,252,28,51,26,43,2,8,14,23,23,27,50,8,6,7,19,46,72
Kent State10,10,Taishaun Johnson,JR,G,Kent State,MAC,8,76,7,23,7,18,0,5,7,12,3,11,14,5,2,1,6,8,21
Kent State11,11,Ryan Bernstein,JR,G,Kent State,MAC,10,44,1,5,1,3,0,2,1,2,2,2,4,2,5,0,0,6,3
Kent State12,12,Johnathan Nwankwo,SO,F,Kent State,MAC,8,22,2,5,2,5,0,0,1,2,1,2,3,0,0,1,1,5,5
Kentucky1,1,Shai Gilgeous-Alexander,FR,G,Kentucky,SEC,33,1096,156,326,137,276,19,50,111,138,27,100,127,168,52,18,86,53,442
Kentucky2,2,Kevin Knox,FR,F,Kentucky,SEC,33,1063,173,388,120,237,53,151,115,149,31,145,176,47,30,8,72,72,514
Kentucky3,3,PJ Washington,FR,F,Kentucky,SEC,33,898,120,235,115,214,5,21,108,174,58,123,181,55,22,30,64,84,353
Kentucky4,4,Hamidou Diallo,FR,G,Kentucky,SEC,33,821,121,291,96,218,25,73,72,118,28,90,118,41,26,8,48,87,339
Kentucky5,5,Quade Green,FR,G,Kentucky,SEC,30,777,107,235,69,136,38,99,37,46,13,44,57,83,11,0,48,49,289
Kentucky6,6,Wenyen Gabriel,SO,F,Kentucky,SEC,33,741,77,174,40,80,37,94,28,48,55,117,172,20,25,35,40,99,219
Kentucky7,7,Nick Richards,FR,F,Kentucky,SEC,33,515,67,109,67,109,0,0,49,67,52,104,156,9,3,32,24,70,183
Kentucky8,8,Sacha Killeya-Jones,SO,F,Kentucky,SEC,30,398,41,68,41,67,0,1,18,34,39,50,89,8,7,17,21,63,100
Kentucky9,9,Jarred Vanderbilt,,F,Kentucky,SEC,14,238,29,68,29,67,0,1,24,38,46,64,110,14,6,11,15,37,82
Kentucky10,10,Tai Wynyard,SO,F,Kentucky,SEC,8,43,3,7,3,7,0,0,2,2,6,8,14,0,3,1,3,8,8
Kentucky11,11,Brad Calipari,SO,G,Kentucky,SEC,11,28,1,7,0,0,1,7,0,0,0,2,2,1,0,0,2,0,3
Kentucky12,12,Jonny David,JR,G,Kentucky,SEC,5,4,0,0,0,0,0,0,0,0,0,0,0,0,0,0,2,1,0
Kentucky13,13,Dillon Pulliam,JR,G,Kentucky,SEC,4,3,0,0,0,0,0,0,0,0,0,0,0,0,0,0,0,0,0
La Salle1,1,Amar Stukes,SR,G,La Salle,A-10,32,1132,93,206,70,151,23,55,62,69,22,57,79,99,37,4,49,82,271
La Salle2,2,Pookie Powell,JR,G,La Salle,A-10,30,1102,178,442,122,265,56,177,95,118,11,114,125,130,25,4,79,55,507
La Salle3,3,Saul Phiri,SO,G,La Salle,A-10,32,976,59,182,23,57,36,125,43,55,32,120,152,47,35,18,31,76,197
La Salle4,4,B.J. Johnson,SR,G,La Salle,A-10,27,951,194,435,147,304,47,131,126,145,57,168,225,19,35,19,68,57,561
La Salle5,5,Tony Washington,SR,C,La Salle,A-10,32,729,104,165,104,165,0,0,38,62,72,130,202,20,10,21,48,101,246
La Salle6,6,Isiah Deas,SO,G,La Salle,A-10,28,687,90,248,56,131,34,117,51,73,19,105,124,38,27,8,47,49,265
La Salle7,7,Miles Brookins,FR,C,La Salle,A-10,29,372,40,67,40,67,0,0,29,37,22,33,55,10,5,12,16,68,109
La Salle8,8,Johnnie Shuler,SR,G,La Salle,A-10,28,330,16,59,6,19,10,40,12,17,5,28,33,37,9,0,19,23,54
La Salle9,9,Jamir Moultrie,FR,G,La Salle,A-10,21,236,38,85,13,27,25,58,8,13,1,14,15,7,6,0,5,24,109
La Salle10,10,Cian Sullivan,FR,C,La Salle,A-10,7,22,0,5,0,4,0,1,1,2,3,5,8,0,0,4,1,4,1
La Salle11,11,Dajour Joseph,FR,G,La Salle,A-10,9,22,4,10,2,5,2,5,0,0,1,0,1,1,0,0,1,5,10
La Salle12,12,Chris Kuhar,FR,G,La Salle,A-10,7,9,1,1,0,0,1,1,0,0,0,5,5,1,0,0,3,1,3
La Salle13,13,Kyle Cooney,FR,G,La Salle,A-10,6,7,0,1,0,0,0,1,0,0,1,0,1,1,0,0,0,1,0
Lafayette1,1,Justin Jaworski,FR,G,Lafayette,Patriot,29,832,103,234,42,92,61,142,46,54,6,58,64,50,14,2,36,52,313
Lafayette2,2,Matt Klinewski,SR,F,Lafayette,Patriot,31,831,177,351,126,232,51,119,105,129,35,144,179,46,14,22,61,74,510
Lafayette3,3,Eric Stafford,SR,G,Lafayette,Patriot,31,794,55,146,38,94,17,52,41,51,19,72,91,96,23,11,54,75,168
Lafayette4,4,Alex Petrie,FR,G,Lafayette,Patriot,31,772,156,358,88,190,68,168,86,95,9,66,75,23,14,0,58,22,466
Lafayette5,5,Paulius Zalys,JR,F,Lafayette,Patriot,31,760,103,207,96,170,7,37,43,62,42,123,165,67,18,12,84,81,256
Lafayette6,6,E.J. Stephens,FR,G,Lafayette,Patriot,30,634,81,157,58,95,23,62,20,33,10,58,68,23,8,9,18,32,205
Lafayette7,7,Kyle Stout,SO,G,Lafayette,Patriot,28,523,35,104,14,26,21,78,13,20,8,69,77,23,14,8,13,52,104
Lafayette8,8,Lukas Jarrett,SO,F,Lafayette,Patriot,30,459,22,57,14,33,8,24,15,26,12,76,88,30,12,19,31,52,67
Lafayette9,9,Myles Cherry,SO,F,Lafayette,Patriot,30,396,30,52,29,48,1,4,18,25,28,79,107,18,10,4,29,48,79
Lafayette10,10,Dylan Hastings,FR,F,Lafayette,Patriot,23,176,12,35,6,16,6,19,3,7,9,31,40,3,1,15,9,21,33
Lafayette11,11,Auston Evans,JR,G,Lafayette,Patriot,6,27,1,3,1,3,0,0,0,4,0,3,3,3,1,1,1,6,2
Lafayette12,12,Cal Reichwein,SO,G,Lafayette,Patriot,12,21,2,5,2,2,0,3,0,1,0,1,1,4,2,0,1,0,4
Lamar1,1,Colton Weisbrod,SR,F,Lamar,Southland,32,1089,165,355,147,313,18,42,121,179,92,163,255,59,37,6,65,80,469
Lamar2,2,Zjori Bosha,SR,G,Lamar,Southland,32,1001,102,239,63,122,39,117,57,99,55,106,161,38,56,12,39,83,300
Lamar3,3,Josh Nzeakor,JR,F,Lamar,Southland,32,892,149,291,149,290,0,1,101,162,98,139,237,22,28,18,55,91,399
Lamar4,4,Nick Garth,JR,G,Lamar,Southland,32,855,139,334,64,133,75,201,79,95,15,57,72,54,19,0,41,48,432
Lamar5,5,Joey Frenchwood,SR,G,Lamar,Southland,28,781,69,199,29,78,40,121,33,48,10,59,69,118,47,4,69,59,211
Lamar6,6,James Harrison,SR,F,Lamar,Southland,31,572,97,242,39,81,58,161,17,21,19,53,72,22,19,4,28,62,269
Lamar7,7,Torey Noel,SR,G,Lamar,Southland,32,563,43,125,33,72,10,53,29,44,9,45,54,90,45,0,56,66,125
Lamar8,8,Tyrin Atwood,SO,G,Lamar,Southland,25,266,40,83,36,73,4,10,24,37,20,46,66,21,12,5,21,43,108
Lamar9,9,Jordan Foster,FR,C,Lamar,Southland,22,198,21,25,21,25,0,0,13,28,17,40,57,2,1,22,18,50,55
Lamar10,10,Avery Sullivan,FR,F,Lamar,Southland,27,196,13,37,13,36,0,1,10,20,20,23,43,9,11,2,13,36,36
Lamar11,11,Da'Shawn Robinson,,G,Lamar,Southland,11,72,6,20,4,8,2,12,2,4,1,8,9,7,4,2,1,9,16
Lamar12,12,Cannon Broussard,FR,G,Lamar,Southland,5,15,3,9,0,3,3,6,2,2,0,0,0,0,1,0,1,1,11
Lehigh1,1,Kahron Ross,SR,G,Lehigh,Patriot,30,983,147,293,109,204,38,89,63,87,16,74,90,127,42,5,55,63,395
Lehigh2,2,Pat Andree,SO,F,Lehigh,Patriot,30,840,126,275,47,91,79,184,46,54,27,148,175,22,16,12,29,69,377
Lehigh3,3,Lance Tejada,JR,G,Lehigh,Patriot,27,796,139,320,62,150,77,170,41,54,11,56,67,54,21,0,49,65,396
Lehigh4,4,Kyle Leufroy,JR,G,Lehigh,Patriot,30,778,96,264,60,149,36,115,72,85,8,138,146,76,28,3,67,54,300
Lehigh5,5,Jordan Cohen,SO,G,Lehigh,Patriot,29,737,100,207,78,140,22,67,48,53,28,75,103,71,27,8,37,54,270
Lehigh6,6,James Karnik,FR,C,Lehigh,Patriot,30,687,85,183,85,183,0,0,43,68,71,125,196,15,14,9,42,102,213
Lehigh7,7,Caleb Bennett,FR,G,Lehigh,Patriot,30,551,59,131,45,97,14,34,33,44,12,58,70,24,11,6,42,64,165
Lehigh8,8,Marques Wilson,FR,G,Lehigh,Patriot,29,491,55,118,29,58,26,60,20,23,17,57,74,35,23,4,27,39,156
Lehigh9,9,Ed Porter,SO,F,Lehigh,Patriot,13,209,22,43,22,43,0,0,4,6,13,22,35,4,2,5,15,26,48
Lehigh10,10,Caleb Sedore,,C,Lehigh,Patriot,8,35,3,6,3,5,0,1,1,4,1,5,6,0,0,0,2,9,7
Lehigh11,11,Shane Acoveno,FR,F,Lehigh,Patriot,7,34,3,4,2,3,1,1,0,0,3,2,5,0,0,0,3,5,7
Lehigh12,12,Josh Wolf,SO,C,Lehigh,Patriot,3,7,0,1,0,1,0,0,2,2,0,1,1,0,0,1,2,1,2
Lehigh13,13,Jay Jay Davis,SR,G,Lehigh,Patriot,1,3,0,0,0,0,0,0,0,0,0,0,0,0,0,0,1,2,0
Liberty1,1,Ryan Kemrite,SR,G,Liberty,Big South,33,1082,106,244,30,70,76,174,41,45,15,75,90,32,19,2,26,61,329
Liberty2,2,Georgie Pacheco-Ortiz,SO,G,Liberty,Big South,34,1040,105,240,63,140,42,100,89,99,11,72,83,88,31,5,52,44,341
Liberty3,3,Lovell Cabbil,JR,G,Liberty,Big South,31,1005,110,283,65,145,45,138,86,101,12,126,138,107,41,12,65,60,351
Liberty4,4,Scottie James,SO,F,Liberty,Big South,34,857,172,279,158,236,14,43,99,134,84,215,299,35,16,28,49,72,457
Liberty5,5,Elijah Cuffee,FR,G,Liberty,Big South,34,812,65,163,34,73,31,90,19,23,9,72,81,62,31,11,45,75,180
Liberty6,6,Caleb Homesley,SO,G,Liberty,Big South,32,604,87,169,59,94,28,75,45,61,14,128,142,59,24,10,47,61,247
Liberty7,7,Keegan McDowell,FR,G,Liberty,Big South,34,447,38,105,17,44,21,61,21,22,4,34,38,20,6,2,20,33,118
Liberty8,8,Myo Baxter-Bell,SO,F,Liberty,Big South,33,426,71,145,70,140,1,5,46,55,26,45,71,37,25,5,43,61,189
Liberty9,9,Isaiah Williams,FR,G,Liberty,Big South,27,387,37,81,34,71,3,10,38,66,22,35,57,22,7,6,39,57,115
Liberty10,10,Ezra Talbert,JR,F,Liberty,Big South,29,215,25,57,18,28,7,29,10,17,14,23,37,7,2,1,10,45,67
Liberty11,11,Zach Farquhar,SR,G,Liberty,Big South,15,45,8,9,1,1,7,8,0,1,0,5,5,1,1,0,2,3,23
Liberty12,12,Brody Hicks,FR,G,Liberty,Big South,11,34,2,5,2,3,0,2,0,0,4,6,10,6,1,2,1,2,4
Lipscomb1,1,Garrison Mathews,JR,G,Lipscomb,A-Sun,32,974,210,444,121,215,89,229,198,248,40,137,177,54,29,9,70,81,707
Lipscomb2,2,Rob Marberry,JR,F,Lipscomb,A-Sun,32,914,213,344,213,343,0,1,87,118,63,122,185,61,21,22,47,72,513
Lipscomb3,3,Michael Buckland,SO,G,Lipscomb,A-Sun,30,906,67,174,29,70,38,104,52,65,18,110,128,94,29,21,64,82,224
Lipscomb4,4,Kenny Cooper,SO,G,Lipscomb,A-Sun,30,816,105,254,94,199,11,55,77,115,16,60,76,119,63,9,91,81,298
Lipscomb5,5,Eli Pepper,JR,F,Lipscomb,A-Sun,32,775,84,167,70,114,14,53,42,78,60,194,254,62,16,21,59,98,224
Lipscomb6,6,Matt Rose,JR,F,Lipscomb,A-Sun,32,639,81,203,19,40,62,163,44,54,21,73,94,31,7,6,24,50,268
Lipscomb7,7,Aaron Korn,SR,G,Lipscomb,A-Sun,32,492,45,119,21,41,24,78,23,36,34,86,120,34,11,2,26,48,137
Lipscomb8,8,Greg Jones,FR,G,Lipscomb,A-Sun,32,341,27,91,14,37,13,54,8,10,6,21,27,20,11,4,23,31,75
Lipscomb9,9,Andrew Fleming,SO,G,Lipscomb,A-Sun,31,263,27,91,21,55,6,36,32,47,14,24,38,18,6,1,34,33,92
Lipscomb10,10,George Brammeier,SR,C,Lipscomb,A-Sun,32,258,34,66,34,66,0,0,13,31,22,29,51,4,11,3,22,49,81
Lipscomb11,11,Asa Duvall,SR,G,Lipscomb,A-Sun,10,55,1,9,1,3,0,6,3,7,2,6,8,2,2,2,1,3,5
Lipscomb12,12,John Matt Merritt,FR,G,Lipscomb,A-Sun,12,53,6,12,3,6,3,6,1,2,2,3,5,3,1,0,2,8,16
Lipscomb13,13,Zach Flener,FR,G,Lipscomb,A-Sun,7,14,1,2,1,2,0,0,0,0,0,0,0,1,0,0,1,2,2
Long Beach State1,1,Gabe Levin,SR,F,Long Beach State,Big West,32,991,194,426,171,365,23,61,180,221,68,164,232,52,32,22,93,85,591
Long Beach State2,2,Deishuan Booker,JR,G,Long Beach State,Big West,32,938,110,220,83,149,27,71,91,106,16,97,113,148,47,7,94,76,338
Long Beach State3,3,Bryan Alberts,JR,G,Long Beach State,Big West,24,684,98,254,39,96,59,158,17,24,9,33,42,24,17,7,21,43,272
Long Beach State4,4,K.J. Byers,JR,G,Long Beach State,Big West,33,667,58,119,52,79,6,40,48,85,34,106,140,31,33,32,55,59,170
Long Beach State5,5,Edon Maxhuni,FR,G,Long Beach State,Big West,33,570,69,179,35,91,34,88,31,33,10,45,55,33,12,0,55,46,203
Long Beach State6,6,Mason Riggins,JR,F,Long Beach State,Big West,30,565,53,85,53,85,0,0,26,46,43,75,118,19,13,20,22,49,132
Long Beach State7,7,Jordan Roberts,FR,G,Long Beach State,Big West,31,551,54,110,53,106,1,4,24,41,34,51,85,32,21,6,33,52,133
Long Beach State8,8,Temidayo Yussuf,JR,F,Long Beach State,Big West,29,546,92,208,92,207,0,1,79,129,75,104,179,37,16,12,60,100,263
Long Beach State9,9,Jordan Griffin,SO,G,Long Beach State,Big West,33,496,61,153,18,41,43,112,14,16,7,39,46,15,7,1,17,9,179
Long Beach State10,10,Barry Ogalue,SR,F,Long Beach State,Big West,23,347,60,112,57,95,3,17,29,37,20,29,49,18,11,2,22,18,152
Long Beach State11,11,LaRond Williams,SO,F,Long Beach State,Big West,11,98,11,24,11,24,0,0,2,6,8,11,19,1,5,7,9,19,24
Long Beach State12,12,Breamon Richard,,G,Long Beach State,Big West,13,69,0,10,0,5,0,5,11,12,0,3,3,4,2,0,3,13,11
Long Beach State13,13,Javonntie Jackson,SO,F,Long Beach State,Big West,10,65,5,11,5,10,0,1,4,6,3,9,12,2,1,1,8,9,14
Long Beach State14,14,Quentin Shropshire,SR,F,Long Beach State,Big West,19,63,1,6,1,6,0,0,1,3,2,6,8,3,1,2,1,14,3
Long Island University1,1,Jashaun Agosto,SO,G,Long Island University,NEC,33,1198,133,333,81,176,52,157,68,90,14,122,136,135,23,2,80,84,386
Long Island University2,2,Joel Hernandez,JR,G,Long Island University,NEC,34,1117,253,544,196,394,57,150,147,221,64,137,201,87,19,17,98,86,710
Long Island University3,3,Raiquan Clark,JR,G,Long Island University,NEC,34,1102,204,366,198,338,6,28,176,234,73,168,241,52,39,14,140,106,590
Long Island University4,4,Julian Batts,SO,G,Long Island University,NEC,34,1008,109,242,46,88,63,154,60,82,15,130,145,78,47,9,42,93,341
Long Island University5,5,Zach Coleman,SR,F,Long Island University,NEC,31,703,73,176,50,96,23,80,31,55,66,135,201,29,19,32,51,87,200
Long Island University6,6,Jamall Robinson,SR,G,Long Island University,NEC,34,582,49,137,18,38,31,99,3,6,18,46,64,19,18,6,12,51,132
Long Island University7,7,Julius Van Sauers,SO,F,Long Island University,NEC,34,377,24,46,16,28,8,18,12,18,22,53,75,10,8,4,21,72,68
Long Island University8,8,Raul Frias,JR,G,Long Island University,NEC,33,352,35,95,10,19,25,76,6,8,12,32,44,13,7,3,10,23,101
Long Island University9,9,Eral Penn,FR,F,Long Island University,NEC,30,305,27,35,27,35,0,0,21,42,32,56,88,5,10,24,10,54,75
Long Island University10,10,Shyheim Hicks,,G,Long Island University,NEC,7,55,6,16,2,4,4,12,5,5,2,4,6,1,0,0,4,11,21
Long Island University11,11,Ashtyn Bradley,SO,G,Long Island University,NEC,9,26,3,15,0,0,3,15,2,2,0,4,4,0,1,0,0,1,11
Longwood1,1,Byron Ashe,SR,G,Longwood,Big South,33,1130,153,426,102,249,51,177,69,92,31,137,168,77,43,9,96,62,426
Longwood2,2,Damarion Geter,SR,F,Longwood,Big South,29,939,92,161,90,156,2,5,55,83,61,150,211,58,25,33,44,69,241
Longwood3,3,Charles Glover,SR,G,Longwood,Big South,29,799,90,208,41,90,49,118,35,52,7,91,98,56,24,2,81,60,264
Longwood4,4,JaShaun Smith,SO,F,Longwood,Big South,33,797,72,175,44,97,28,78,33,56,23,39,62,11,22,20,38,49,205
Longwood5,5,Isaiah Walton,JR,G,Longwood,Big South,27,785,140,327,84,178,56,149,84,100,7,65,72,59,32,7,84,61,420
Longwood6,6,Spencer Franklin,JR,F,Longwood,Big South,28,576,53,108,50,94,3,14,55,88,40,63,103,13,13,11,39,98,164
Longwood7,7,Chris Shields,JR,F,Longwood,Big South,22,456,35,104,26,59,9,45,10,15,20,83,103,10,9,3,36,43,89
Longwood8,8,Kamil Chapman,FR,G,Longwood,Big South,28,399,41,122,15,35,26,87,35,43,3,37,40,11,19,0,32,40,143
Longwood9,9,Jordan Cintron,FR,F,Longwood,Big South,28,373,25,55,23,48,2,7,14,34,20,45,65,14,18,5,28,42,66
Longwood10,10,Jahleem Montague,SO,F,Longwood,Big South,17,222,20,49,20,47,0,2,11,17,14,30,44,11,8,10,22,35,51
Longwood11,11,Boaz Williams,JR,F,Longwood,Big South,7,71,3,20,3,13,0,7,2,2,3,7,10,2,1,2,6,11,8
Longwood12,12,Dominic Ezeani,SO,G,Longwood,Big South,21,53,4,8,4,7,0,1,3,9,0,5,5,5,4,0,3,4,11
Louisiana1,1,Frank Bartley,SR,G,Louisiana,Sun Belt,32,980,171,396,89,182,82,214,141,164,20,95,115,65,42,3,61,60,565
Louisiana2,2,Bryce Washington,SR,F,Louisiana,Sun Belt,33,976,134,252,134,249,0,3,78,121,121,228,349,70,43,28,67,81,346
Louisiana3,3,Malik Marquetti,JR,G,Louisiana,Sun Belt,33,909,91,220,39,95,52,125,43,51,34,85,119,63,29,6,42,56,277
Louisiana4,4,Marcus Stroman,JR,G,Louisiana,Sun Belt,32,879,60,140,50,97,10,43,84,112,13,80,93,205,55,8,92,88,214
Louisiana5,5,Jakeenan Gant,JR,F,Louisiana,Sun Belt,31,793,172,308,142,217,30,91,54,78,68,113,181,28,18,72,39,69,428
Louisiana6,6,Johnathan Stove,SR,G,Louisiana,Sun Belt,28,531,88,164,74,127,14,37,85,104,35,47,82,47,13,14,36,62,275
Louisiana7,7,Cedric Russell,FR,G,Louisiana,Sun Belt,33,496,63,151,10,30,53,121,5,8,7,28,35,23,15,0,22,53,184
Louisiana8,8,Justin Miller,SO,F,Louisiana,Sun Belt,31,431,77,179,62,124,15,55,57,72,43,73,116,37,13,4,36,66,226
Louisiana9,9,P.J. Hardy,SO,G,Louisiana,Sun Belt,25,231,26,74,8,22,18,52,10,14,6,25,31,22,8,2,14,27,80
Louisiana10,10,Jerekius Davis,SO,F,Louisiana,Sun Belt,23,167,35,75,26,45,9,30,6,11,12,21,33,6,5,2,7,14,85
Louisiana11,11,Larenz Stalcup,SR,C,Louisiana,Sun Belt,25,130,19,37,19,37,0,0,8,15,10,15,25,8,3,4,5,32,46
Louisiana12,12,Jacob Broussard,SR,G,Louisiana,Sun Belt,18,63,5,14,0,1,5,13,2,2,0,4,4,7,3,0,6,8,17
Louisiana13,13,Mason Aucoin,SO,G,Louisiana,Sun Belt,12,38,3,9,1,3,2,6,2,4,1,7,8,1,3,0,4,5,10
Louisiana14,14,Kadavion Evans,,G,Louisiana,Sun Belt,1,1,0,0,0,0,0,0,0,0,0,0,0,0,0,0,0,0,0
Louisiana State1,1,Tremont Waters,FR,G,Louisiana State,SEC,31,1031,159,383,88,186,71,197,108,135,10,96,106,182,63,3,90,66,497
Louisiana State2,2,Skylar Mays,SO,G,Louisiana State,SEC,31,966,114,262,72,137,42,125,77,92,17,110,127,96,49,7,50,50,347
Louisiana State3,3,Duop Reath,SR,F,Louisiana State,SEC,31,747,153,284,137,246,16,38,57,93,60,101,161,21,13,28,52,76,379
Louisiana State4,4,Aaron Epps,SR,F,Louisiana State,SEC,30,703,107,205,73,109,34,96,36,46,56,112,168,12,11,26,21,75,284
Louisiana State5,5,Daryl Edwards,JR,G,Louisiana State,SEC,30,651,71,149,33,51,38,98,26,31,6,40,46,38,18,3,27,50,206
Louisiana State6,6,Wayde Sims,SO,F,Louisiana State,SEC,30,531,71,138,62,102,9,36,23,34,33,57,90,12,14,19,20,59,174
Louisiana State7,7,Brandon Sampson,JR,G,Louisiana State,SEC,25,477,65,138,38,61,27,77,33,48,17,48,65,22,24,2,26,41,190
Louisiana State8,8,Randy Onwuasor,SR,G,Louisiana State,SEC,30,456,47,102,36,76,11,26,30,40,19,40,59,26,16,2,27,46,135
Louisiana State9,9,Brandon Rachal,FR,G,Louisiana State,SEC,27,429,48,90,47,85,1,5,22,40,30,58,88,19,26,5,19,58,119
Louisiana State10,10,Marshall Graves,SO,G,Louisiana State,SEC,13,62,7,17,3,5,4,12,0,0,1,4,5,7,0,0,3,5,18
Louisiana State11,11,Galen Alexander,FR,F,Louisiana State,SEC,9,55,6,16,4,5,2,11,3,4,5,14,19,1,1,0,2,5,17
Louisiana State12,12,Jeremy Combs,SR,F,Louisiana State,SEC,6,52,7,11,7,11,0,0,4,8,4,8,12,4,2,3,4,13,18
Louisiana State13,13,Mayan Kiir,FR,F,Louisiana State,SEC,8,43,5,11,5,11,0,0,5,9,9,7,16,2,1,2,6,5,15
Louisiana State14,14,Reed Vial,JR,G,Louisiana State,SEC,9,22,1,6,0,1,1,5,2,2,1,1,2,0,0,0,0,2,5
Louisiana Tech1,1,Jacobi Boykins,SR,G,Louisiana Tech,CUSA,33,1008,145,343,47,95,98,248,97,106,18,142,160,50,33,11,39,73,485
Louisiana Tech2,2,Derric Jean,JR,G,Louisiana Tech,CUSA,32,847,97,234,47,120,50,114,61,82,20,79,99,61,35,5,54,76,305
Louisiana Tech3,3,Oliver Powell,SO,F,Louisiana Tech,CUSA,32,750,94,170,94,168,0,2,46,70,44,103,147,17,11,20,33,56,234
Louisiana Tech4,4,Anthony Duruji,FR,F,Louisiana Tech,CUSA,32,682,82,182,54,111,28,71,37,62,36,95,131,26,12,44,38,78,229
Louisiana Tech5,5,DaQuan Bracey,SO,G,Louisiana Tech,CUSA,25,622,113,241,87,177,26,64,59,92,16,31,47,103,22,2,61,42,311
Louisiana Tech6,6,Jy'lan Washington,,F,Louisiana Tech,CUSA,33,619,66,158,44,78,22,80,42,57,42,73,115,19,16,10,25,52,196
Louisiana Tech7,7,Amorie Archibald,FR,G,Louisiana Tech,CUSA,29,604,71,181,52,117,19,64,56,77,19,58,77,117,24,4,55,43,217
Louisiana Tech8,8,Exavian Christon,FR,G,Louisiana Tech,CUSA,33,542,57,135,34,65,23,70,22,25,11,59,70,21,18,2,25,45,159
Louisiana Tech9,9,Joniah White,JR,C,Louisiana Tech,CUSA,20,338,30,58,30,58,0,0,21,33,35,48,83,10,5,26,23,40,81
Louisiana Tech10,10,JaColby Pemberton,FR,G,Louisiana Tech,CUSA,27,276,22,43,20,36,2,7,18,30,16,31,47,18,8,2,18,35,64
Louisiana Tech11,11,Jalen Harris,SO,G,Louisiana Tech,CUSA,11,276,54,113,38,77,16,36,44,53,8,40,48,26,12,3,28,22,168
Louisiana Tech12,12,Kyle McKinley,SO,C,Louisiana Tech,CUSA,7,28,3,6,3,6,0,0,1,8,2,4,6,0,0,2,1,4,7
Louisiana Tech13,13,Jeremiah Taylor,SO,G,Louisiana Tech,CUSA,8,26,4,12,1,3,3,9,0,0,0,5,5,2,0,0,1,2,11
Louisiana Tech14,14,Harrison Curry,JR,F,Louisiana Tech,CUSA,1,6,0,1,0,1,0,0,1,2,0,2,2,0,0,0,0,1,1
Louisiana-Monroe1,1,Travis Munnings,JR,F,Louisiana-Monroe,Sun Belt,31,1055,177,378,108,204,69,174,69,93,51,172,223,68,38,6,48,82,492
Louisiana-Monroe2,2,Sam McDaniel,SR,G,Louisiana-Monroe,Sun Belt,31,1032,162,376,85,198,77,178,85,106,37,140,177,67,32,9,68,76,486
Louisiana-Monroe3,3,Michael Ertel,FR,G,Louisiana-Monroe,Sun Belt,31,943,133,309,83,161,50,148,36,57,13,88,101,76,23,1,34,52,352
Louisiana-Monroe4,4,Marvin Jean-Pierre,SR,G,Louisiana-Monroe,Sun Belt,31,890,129,269,100,180,29,89,45,65,60,96,156,72,38,8,55,83,332
Louisiana-Monroe5,5,Jordon Harris,SR,G,Louisiana-Monroe,Sun Belt,31,813,86,240,48,113,38,127,20,27,20,47,67,97,36,0,55,46,230
Louisiana-Monroe6,6,Sam Alabakis,SO,C,Louisiana-Monroe,Sun Belt,30,592,31,61,31,61,0,0,23,39,25,66,91,1,6,5,32,75,85
Louisiana-Monroe7,7,Brandon Newman,JR,G,Louisiana-Monroe,Sun Belt,28,314,22,56,15,33,7,23,22,27,4,42,46,31,11,2,16,32,73
Louisiana-Monroe8,8,Roderick Taylor,JR,F,Louisiana-Monroe,Sun Belt,19,217,16,35,14,29,2,6,6,9,7,24,31,8,4,3,16,35,40
Louisiana-Monroe9,9,Majok Deng,JR,F,Louisiana-Monroe,Sun Belt,17,188,14,27,14,27,0,0,4,9,22,15,37,4,5,6,5,18,32
Louisiana-Monroe10,10,Donovan Walker,JR,G,Louisiana-Monroe,Sun Belt,16,103,8,29,4,20,4,9,2,3,2,3,5,6,5,0,10,12,22
Louisiana-Monroe11,11,Calvin Anderson,JR,G,Louisiana-Monroe,Sun Belt,7,53,3,15,2,6,1,9,3,4,1,12,13,2,0,0,4,3,10
Louisiana-Monroe12,12,Lance Richard,SR,G,Louisiana-Monroe,Sun Belt,11,50,5,14,0,1,5,13,0,0,0,1,1,4,2,0,1,0,15
Louisville1,1,Quentin Snider,SR,G,Louisville,ACC,33,1074,129,314,66,160,63,154,80,91,15,76,91,132,17,0,51,36,401
Louisville2,2,Deng Adel,JR,F,Louisville,ACC,31,1050,166,374,118,237,48,137,96,123,21,145,166,91,19,11,69,46,476
Louisville3,3,Raymond Spalding,JR,F,Louisville,ACC,33,895,166,307,162,291,4,16,70,108,105,178,283,40,47,53,54,99,406
Louisville4,4,V.J. King,SO,F,Louisville,ACC,33,827,99,246,75,174,24,72,65,90,18,87,105,28,21,4,47,58,287
Louisville5,5,Anas Mahmoud,SR,F,Louisville,ACC,33,813,105,189,105,189,0,0,27,58,60,116,176,37,29,97,47,67,237
Louisville6,6,Dwayne Sutton,SO,F,Louisville,ACC,33,493,50,108,33,63,17,45,25,38,36,93,129,20,26,13,17,61,142
Louisville7,7,Darius Perry,FR,G,Louisville,ACC,33,448,34,97,14,37,20,60,32,34,6,32,38,49,17,3,35,56,120
Louisville8,8,Ryan McMahon,,G,Louisville,ACC,26,397,44,112,9,22,35,90,26,30,4,24,28,37,24,2,28,44,149
Louisville9,9,Malik Williams,FR,F,Louisville,ACC,31,332,46,109,26,48,20,61,11,16,22,53,75,5,12,13,11,30,123
Louisville10,10,Jordan Nwora,FR,F,Louisville,ACC,25,290,45,92,25,48,20,44,25,33,11,43,54,10,16,3,19,32,135
Louisville11,11,Lance Thomas,FR,F,Louisville,ACC,11,49,9,14,7,7,2,7,6,8,3,12,15,0,2,2,3,12,26
Louisville12,12,Jo Griffin,FR,G,Louisville,ACC,7,19,0,1,0,0,0,1,0,0,0,0,0,2,1,0,1,2,0
Louisville13,13,Jacob Redding,FR,G,Louisville,ACC,6,13,4,4,1,1,3,3,2,2,0,0,0,0,0,0,0,0,13
Loyola (IL)1,1,Donte Ingram,SR,G,Loyola (IL),MVC,33,1014,134,297,67,129,67,168,49,70,18,196,214,51,34,12,47,49,384
Loyola (IL)2,2,Marques Townes,JR,G,Loyola (IL),MVC,33,920,140,270,113,203,27,67,62,86,21,108,129,78,31,7,65,47,369
Loyola (IL)3,3,Clayton Custer,JR,G,Loyola (IL),MVC,28,907,137,262,86,146,51,116,51,66,7,56,63,119,43,2,59,49,376
Loyola (IL)4,4,Cameron Krutwig,FR,C,Loyola (IL),MVC,33,790,136,226,136,226,0,0,75,102,65,144,209,57,17,25,44,42,347
Loyola (IL)5,5,Ben Richardson,SR,G,Loyola (IL),MVC,23,701,50,113,19,35,31,78,22,33,3,62,65,86,30,9,38,46,153
Loyola (IL)6,6,Lucas Williamson,FR,G,Loyola (IL),MVC,33,651,46,104,16,34,30,70,35,47,9,57,66,33,29,9,25,65,157
Loyola (IL)7,7,Aundre Jackson,SR,F,Loyola (IL),MVC,33,631,147,255,128,204,19,51,46,65,30,81,111,34,16,9,53,81,359
Loyola (IL)8,8,Bruno Skokna,SO,G,Loyola (IL),MVC,33,410,37,77,21,31,16,46,25,29,6,24,30,21,14,2,17,25,115
Loyola (IL)9,9,Cameron Satterwhite,SO,G,Loyola (IL),MVC,31,347,18,54,14,35,4,19,20,28,4,50,54,31,2,3,28,25,60
Loyola (IL)10,10,Adarius Avery,,G,Loyola (IL),MVC,12,94,13,27,13,26,0,1,10,15,8,15,23,4,1,2,7,7,36
Loyola (IL)11,11,Christian Negron,FR,F,Loyola (IL),MVC,15,70,5,14,5,14,0,0,7,16,3,9,12,2,1,1,5,12,17
Loyola (IL)12,12,Carson Shanks,SR,C,Loyola (IL),MVC,11,29,4,8,4,7,0,1,2,2,0,4,4,1,0,1,1,5,10
Loyola (IL)13,13,Jake Baughman,SO,G,Loyola (IL),MVC,8,18,1,1,0,0,1,1,2,2,0,0,0,0,1,0,1,2,5
Loyola (IL)14,14,Nick DiNardi,SR,F,Loyola (IL),MVC,7,11,1,5,1,5,0,0,0,0,2,2,4,0,0,0,1,0,2
Loyola (IL)15,15,Dylan Boehm,FR,F,Loyola (IL),MVC,5,7,0,1,0,1,0,0,0,0,0,0,0,2,0,0,0,1,0
Loyola (MD)1,1,Andre Walker,SR,G,Loyola (MD),Patriot,29,929,168,438,102,241,66,197,55,93,28,85,113,80,47,0,84,83,457
Loyola (MD)2,2,Cam Gregory,SR,F,Loyola (MD),Patriot,31,900,130,222,130,222,0,0,70,107,95,160,255,17,15,20,50,78,330
Loyola (MD)3,3,Isaiah Hart,FR,G,Loyola (MD),Patriot,31,838,125,257,116,228,9,29,60,92,7,53,60,90,32,5,82,71,319
Loyola (MD)4,4,Chuck Champion,SO,G,Loyola (MD),Patriot,26,798,118,298,92,217,26,81,38,54,19,54,73,42,25,1,50,46,300
Loyola (MD)5,5,Andrew Kostecka,SO,G,Loyola (MD),Patriot,26,751,98,217,77,152,21,65,70,94,17,78,95,48,54,29,39,70,287
Loyola (MD)6,6,Sam Norton,JR,G,Loyola (MD),Patriot,25,455,22,52,18,44,4,8,22,29,22,57,79,23,11,4,14,57,70
Loyola (MD)7,7,Brent Holcombe,FR,F,Loyola (MD),Patriot,26,396,47,119,31,65,16,54,15,25,23,77,100,11,7,18,26,52,125
Loyola (MD)8,8,KaVaughn Scott,SO,F,Loyola (MD),Patriot,26,370,32,64,32,64,0,0,35,65,37,62,99,7,11,14,26,64,99
Loyola (MD)9,9,Luke Johnson,FR,G,Loyola (MD),Patriot,24,220,16,32,12,22,4,10,2,2,6,16,22,9,4,0,2,14,38
Loyola (MD)10,10,James Fives,JR,G,Loyola (MD),Patriot,9,204,13,39,4,14,9,25,11,18,7,28,35,5,3,1,11,21,46
Loyola (MD)11,11,River Reed,,F,Loyola (MD),Patriot,15,135,14,23,14,21,0,2,8,16,8,15,23,6,2,4,5,24,36
Loyola (MD)12,12,Ian Langendoerfer,SO,F,Loyola (MD),Patriot,14,131,6,26,3,13,3,13,7,9,8,13,21,7,1,1,11,16,22
Loyola (MD)13,13,Nevell Provo,JR,G,Loyola (MD),Patriot,12,89,5,25,1,4,4,21,0,0,1,7,8,3,3,0,3,11,14
Loyola (MD)14,14,Matt Staubi,SR,G,Loyola (MD),Patriot,10,49,3,6,2,3,1,3,2,2,0,2,2,11,2,0,3,5,9
Loyola (MD)15,15,Ethan Norton,FR,G,Loyola (MD),Patriot,4,10,0,2,0,1,0,1,2,2,0,1,1,1,1,0,0,2,2
Loyola Marymount1,1,James Batemon,JR,G,Loyola Marymount,WCC,30,1050,167,351,125,242,42,109,157,196,34,77,111,140,35,2,88,82,533
Loyola Marymount2,2,Eli Scott,FR,F,Loyola Marymount,WCC,31,958,148,314,146,299,2,15,94,155,89,138,227,72,24,10,84,65,392
Loyola Marymount3,3,Mattias Markusson,SO,C,Loyola Marymount,WCC,31,772,118,190,118,190,0,0,32,51,68,128,196,19,20,34,29,85,268
Loyola Marymount4,4,Jeffery McClendon,JR,G,Loyola Marymount,WCC,31,749,48,140,31,76,17,64,17,23,35,52,87,54,65,5,42,93,130
Loyola Marymount5,5,Steven Haney,SR,F,Loyola Marymount,WCC,24,730,96,250,30,90,66,160,51,66,6,51,57,35,19,1,29,47,309
Loyola Marymount6,6,Cameron Allen,SO,G,Loyola Marymount,WCC,31,556,59,162,41,109,18,53,28,42,10,37,47,57,13,4,42,44,164
Loyola Marymount7,7,Zafir Williams,FR,F,Loyola Marymount,WCC,31,539,85,160,77,148,8,12,25,33,51,58,109,21,12,9,30,94,203
Loyola Marymount8,8,Erik Johansson,SO,G,Loyola Marymount,WCC,30,357,31,82,8,14,23,68,5,8,2,18,20,11,7,0,12,20,90
Loyola Marymount9,9,Joe Quintana,FR,G,Loyola Marymount,WCC,21,214,15,59,4,21,11,38,0,0,4,8,12,15,8,1,13,14,41
Loyola Marymount10,10,Donald Gipson,FR,G,Loyola Marymount,WCC,17,152,18,64,11,30,7,34,4,4,6,14,20,10,9,0,12,25,47
Loyola Marymount11,11,Mikail Simmons,FR,F,Loyola Marymount,WCC,20,144,15,36,10,17,5,19,5,9,12,16,28,6,4,3,10,36,40
Loyola Marymount12,12,Petr Herman,SR,F,Loyola Marymount,WCC,1,19,3,5,3,5,0,0,1,2,2,3,5,1,0,2,1,2,7
Loyola Marymount13,13,Dylan Causwell,SO,F,Loyola Marymount,WCC,4,10,0,2,0,1,0,1,2,4,0,2,2,0,0,1,0,0,2
Maine1,1,Aaron Calixte,SR,G,Maine,AEC,32,1062,187,393,126,235,61,158,107,120,16,84,100,101,28,4,121,74,542
Maine2,2,Andrew Fleming,SO,F,Maine,AEC,32,858,119,289,113,256,6,33,67,97,60,110,170,42,17,25,82,106,311
Maine3,3,Isaiah White,FR,G,Maine,AEC,24,660,98,226,63,128,35,98,35,50,28,83,111,19,29,29,36,52,266
Maine4,4,Ilija Stojiljkovic,JR,F,Maine,AEC,31,623,51,107,38,72,13,35,17,40,35,123,158,28,19,9,39,73,132
Maine5,5,Celio Araujo,FR,G,Maine,AEC,32,568,12,44,8,20,4,24,15,19,3,38,41,59,26,2,36,53,43
Maine6,6,Ilker Er,SR,G,Maine,AEC,28,522,82,241,52,111,30,130,27,39,27,75,102,13,11,2,19,64,221
Maine7,7,Vernon Lowndes Jr.,FR,G,Maine,AEC,29,457,68,141,53,94,15,47,38,56,21,73,94,16,22,7,51,50,189
Maine8,8,Danny Evans,SO,G,Maine,AEC,31,419,40,103,23,49,17,54,18,25,17,48,65,24,16,4,26,38,115
Maine9,9,Dennis Ashley,SO,G,Maine,AEC,31,405,40,119,20,55,20,64,20,32,8,38,46,20,13,0,21,31,120
Maine10,10,Dusan Majstorovic,JR,G,Maine,AEC,24,380,33,107,20,49,13,58,16,20,17,38,55,16,14,4,20,35,95
Maine11,11,Miks Antoms,FR,F,Maine,AEC,28,259,19,48,19,48,0,0,15,50,22,35,57,12,5,5,19,30,53
Maine12,12,Trae Bryant,FR,G,Maine,AEC,7,180,11,35,3,9,8,26,8,10,3,21,24,20,2,1,9,10,38
Maine13,13,Garvey Melmed,JR,G,Maine,AEC,15,63,5,16,2,2,3,14,2,2,2,5,7,5,3,0,2,5,15
Maine14,14,Duncan Douglas,FR,F,Maine,AEC,2,19,0,2,0,0,0,2,0,0,0,1,1,0,0,1,1,3,0
Manhattan1,1,Rich Williams,SR,G,Manhattan,MAAC,29,908,149,340,94,211,55,129,53,67,22,112,134,77,21,4,83,61,406
Manhattan2,2,Zavier Turner,SR,G,Manhattan,MAAC,31,898,90,213,53,125,37,88,111,137,14,55,69,132,26,0,79,75,328
Manhattan3,3,Zane Waterman,SR,F,Manhattan,MAAC,31,881,129,274,94,177,35,97,77,121,63,142,205,34,19,12,69,79,370
Manhattan4,4,Calvin Crawford,SR,F,Manhattan,MAAC,31,836,91,224,56,133,35,91,34,43,37,106,143,43,22,17,61,64,251
Manhattan5,5,Pauly Paulicap,SO,F,Manhattan,MAAC,31,734,111,199,111,199,0,0,88,142,92,121,213,8,8,78,50,106,310
Manhattan6,6,Thomas Capuano,,G,Manhattan,MAAC,31,705,61,123,30,62,31,61,6,14,11,49,60,36,18,2,26,59,159
Manhattan7,7,Aaron Walker,FR,G,Manhattan,MAAC,23,480,62,163,43,109,19,54,45,69,9,36,45,46,33,3,55,43,188
Manhattan8,8,Nehemiah Mack,FR,G,Manhattan,MAAC,30,442,19,47,9,17,10,30,8,13,9,17,26,38,22,0,21,66,56
Manhattan9,9,Patrick Strzala,FR,G,Manhattan,MAAC,27,215,18,55,1,11,17,44,7,7,3,12,15,9,7,0,12,25,60
Manhattan10,10,Ebube Ebube,FR,F,Manhattan,MAAC,25,178,6,19,6,15,0,4,3,9,21,13,34,10,10,5,7,33,15
Manhattan11,11,Ibrahima Diallo,,F,Manhattan,MAAC,7,16,1,4,1,4,0,0,2,3,3,6,9,0,0,0,3,5,4
Manhattan12,12,Matt Maloney,,G,Manhattan,MAAC,4,3,0,0,0,0,0,0,0,0,0,0,0,0,0,0,0,0,0
Manhattan13,13,Jesse Boyce,,G,Manhattan,MAAC,3,3,0,0,0,0,0,0,0,0,0,1,1,0,0,0,0,0,0
Manhattan14,14,David Varoli,,G,Manhattan,MAAC,2,1,0,0,0,0,0,0,0,0,0,0,0,0,0,0,0,0,0
Marist1,1,Brian Parker,JR,G,Marist,MAAC,30,972,165,350,136,260,29,90,153,216,27,132,159,101,14,3,121,76,512
Marist2,2,Ryan Funk,JR,F,Marist,MAAC,30,939,108,257,31,68,77,189,53,70,9,78,87,14,13,5,24,55,346
Marist3,3,David Knudsen,JR,F,Marist,MAAC,30,937,108,248,49,88,59,160,50,60,15,74,89,63,28,7,59,53,325
Marist4,4,Tobias Sjoberg,SO,C,Marist,MAAC,29,673,63,100,63,100,0,0,23,36,61,104,165,43,8,25,52,97,149
Marist5,5,Aleksandar Dozic,SO,F,Marist,MAAC,29,670,77,194,41,79,36,115,22,32,21,103,124,52,8,6,50,62,212
Marist6,6,Isaiah Lamb,JR,F,Marist,MAAC,29,638,74,180,54,112,20,68,56,73,16,65,81,17,14,5,46,49,224
Marist7,7,Austin Williams,FR,G,Marist,MAAC,29,483,68,143,63,112,5,31,33,58,11,71,82,35,20,4,63,68,174
Marist8,8,Lasse Gummerus,FR,F,Marist,MAAC,29,416,47,109,16,26,31,83,16,18,7,61,68,13,5,1,12,14,141
Marist9,9,Connor McClenaghan,SR,C,Marist,MAAC,29,280,29,69,17,38,12,31,10,16,13,33,46,13,8,15,17,47,80
Marist10,10,Andrea Bernardi,FR,G,Marist,MAAC,20,127,10,30,6,14,4,16,20,26,7,11,18,6,8,2,20,17,44
Marist11,11,Kristinn Palsson,JR,F,Marist,MAAC,9,125,9,21,2,4,7,17,0,0,3,20,23,10,2,4,7,7,25
Marist12,12,Ryan Carmello,FR,G,Marist,MAAC,11,18,2,4,2,3,0,1,1,7,2,0,2,2,1,0,2,0,5
Marist13,13,Tucker Lee,FR,G,Marist,MAAC,9,11,0,2,0,1,0,1,0,0,0,1,1,0,0,0,0,1,0
Marist14,14,Michael Servetas,FR,G,Marist,MAAC,9,11,1,3,1,3,0,0,0,0,0,3,3,0,1,0,0,1,2
Marquette1,1,Sam Hauser,SO,G,Marquette,Big East,32,1066,166,327,75,148,91,179,49,59,33,158,191,89,32,15,40,67,472
Marquette2,2,Andrew Rowsey,SR,G,Marquette,Big East,32,1031,189,454,79,181,110,273,155,171,12,90,102,146,31,7,89,77,643
Marquette3,3,Markus Howard,SO,G,Marquette,Big East,31,986,219,473,117,217,102,256,93,99,11,89,100,89,30,2,75,74,633
Marquette4,4,Sacar Anim,SO,F,Marquette,Big East,32,854,95,199,87,165,8,34,47,77,41,51,92,56,26,1,41,87,245
Marquette5,5,Matt Heldt,JR,C,Marquette,Big East,32,701,50,78,50,78,0,0,27,31,52,99,151,25,9,30,15,92,127
Marquette6,6,Greg Elliott,FR,G,Marquette,Big East,32,586,49,96,38,69,11,27,32,41,23,55,78,47,28,22,30,62,141
Marquette7,7,Jamal Cain,FR,F,Marquette,Big East,31,520,49,106,26,56,23,50,9,21,24,73,97,19,23,12,29,38,130
Marquette8,8,Theo John,FR,F,Marquette,Big East,30,342,48,85,48,85,0,0,14,32,23,39,62,6,11,23,32,75,110
Marquette9,9,Harry Froling,,C,Marquette,Big East,19,243,25,55,21,36,4,19,2,5,19,40,59,20,2,4,16,29,56
Marquette10,10,Haanif Cheatham,JR,G,Marquette,Big East,5,131,16,37,11,24,5,13,4,7,2,12,14,7,5,0,8,7,41
Marquette11,11,Cam Marotta,JR,G,Marquette,Big East,7,12,0,2,0,1,0,1,0,0,0,1,1,0,0,0,0,2,0
Marquette12,12,Mike Lelito,FR,G,Marquette,Big East,1,3,0,1,0,0,0,1,0,0,0,0,0,0,0,0,0,0,0
Marshall1,1,Jon Elmore,JR,G,Marshall,CUSA,34,1303,233,529,142,270,91,259,217,262,15,188,203,234,52,13,121,52,774
Marshall2,2,C.J. Burks,JR,G,Marshall,CUSA,33,1186,251,520,168,293,83,227,92,103,17,119,136,102,32,4,104,71,677
Marshall3,3,Jarrod West,FR,G,Marshall,CUSA,34,1098,90,201,29,54,61,147,28,41,11,78,89,101,52,2,49,73,269
Marshall4,4,Ajdin Penava,JR,F,Marshall,CUSA,32,938,178,322,147,229,31,93,110,147,63,210,273,60,32,125,61,114,497
Marshall5,5,Rondale Watson,,G,Marshall,CUSA,23,613,71,157,49,95,22,62,23,35,28,60,88,31,23,7,29,54,187
Marshall6,6,Jannson Williams,FR,F,Marshall,CUSA,33,544,61,127,37,61,24,66,31,41,29,80,109,7,16,27,19,61,177
Marshall7,7,Darius George,FR,F,Marshall,CUSA,26,373,45,90,32,50,13,40,17,38,26,59,85,8,18,10,18,52,120
Marshall8,8,Milan Mijovic,SR,F,Marshall,CUSA,24,313,16,39,16,38,0,1,7,12,12,39,51,15,5,6,19,45,39
Marshall9,9,Dani Koljanin,JR,F,Marshall,CUSA,21,231,17,47,11,22,6,25,8,14,10,27,37,14,2,2,9,26,48
Marshall10,10,Phil Bledsoe,SO,F,Marshall,CUSA,18,135,23,51,19,34,4,17,5,6,13,19,32,2,1,1,6,22,55
Marshall11,11,Ot Elmore,SR,G,Marshall,CUSA,10,78,5,20,0,1,5,19,0,0,2,4,6,8,0,0,2,6,15
Marshall12,12,Christian Thieneman,SO,F,Marshall,CUSA,7,45,2,8,1,3,1,5,1,3,1,9,10,0,0,1,3,8,6
Marshall13,13,Marcus Reed,SR,G,Marshall,CUSA,3,9,0,2,0,0,0,2,1,2,1,3,4,3,0,0,0,1,1
Marshall14,14,Christian Villers,,G,Marshall,CUSA,2,5,0,2,0,1,0,1,0,0,0,1,1,0,0,0,0,1,0
Marshall15,15,Will Fenton,FR,G,Marshall,CUSA,1,4,0,0,0,0,0,0,0,0,0,2,2,0,0,0,0,0,0
Maryland1,1,Anthony Cowan,SO,G,Maryland,Big Ten,32,1184,144,341,90,194,54,147,162,191,7,133,140,164,48,10,89,64,504
Maryland2,2,Kevin Huerter,SO,G,Maryland,Big Ten,32,1099,162,322,89,147,73,175,75,99,31,130,161,108,20,21,80,76,472
Maryland3,3,Darryl Morsell,FR,G,Maryland,Big Ten,32,921,101,238,98,213,3,25,72,99,52,89,141,65,19,15,70,64,277
Maryland4,4,Bruno Fernando,FR,F,Maryland,Big Ten,30,671,118,204,117,201,1,3,71,96,45,151,196,21,11,37,53,87,308
Maryland5,5,Dion Wiley,JR,G,Maryland,Big Ten,28,607,59,141,23,43,36,98,7,9,7,44,51,19,13,4,22,31,161
Maryland6,6,Jared Nickens,SR,F,Maryland,Big Ten,32,514,56,135,13,31,43,104,8,13,10,34,44,10,5,4,16,28,163
Maryland7,7,Michal Cekovsky,SR,C,Maryland,Big Ten,28,473,75,112,75,111,0,1,30,47,30,55,85,11,6,27,28,67,180
Maryland8,8,Justin Jackson,SO,F,Maryland,Big Ten,11,323,37,101,27,61,10,40,24,29,27,62,89,21,9,9,32,15,108
Maryland9,9,Joshua Tomaic,FR,F,Maryland,Big Ten,26,230,20,31,13,16,7,15,10,17,17,30,47,8,0,6,10,21,57
Maryland10,10,Ivan Bender,JR,F,Maryland,Big Ten,15,184,19,33,18,30,1,3,12,18,14,30,44,21,1,2,21,25,51
Maryland11,11,Sean Obi,SR,C,Maryland,Big Ten,21,125,11,19,11,19,0,0,7,12,14,26,40,2,2,2,7,24,29
Maryland12,12,Reese Mona,FR,G,Maryland,Big Ten,12,45,4,6,4,5,0,1,7,9,3,2,5,0,3,0,2,6,15
Maryland13,13,Travis Valmon,SO,G,Maryland,Big Ten,9,20,4,7,3,5,1,2,0,1,1,4,5,0,1,0,2,1,9
Maryland14,14,Alex Tostado,FR,G,Maryland,Big Ten,8,16,1,3,1,2,0,1,2,3,0,0,0,1,0,0,0,1,4
Maryland15,15,Andrew Terrell,JR,G,Maryland,Big Ten,6,13,0,3,0,1,0,2,0,2,0,1,1,1,0,0,0,1,0
Maryland-Baltimore County1,1,K.J. Maura,SR,G,Maryland-Baltimore County,AEC,31,1081,117,250,57,108,60,142,59,68,20,48,68,162,61,0,56,47,353
Maryland-Baltimore County2,2,Jairus Lyles,SR,G,Maryland-Baltimore County,AEC,31,1074,212,486,138,295,74,191,127,158,23,150,173,110,64,6,97,61,625
Maryland-Baltimore County3,3,Joe Sherburne,JR,F,Maryland-Baltimore County,AEC,34,985,139,298,65,123,74,175,18,27,28,103,131,65,29,11,32,67,370
Maryland-Baltimore County4,4,Arkel Lamar,SO,F,Maryland-Baltimore County,AEC,31,840,109,275,46,129,63,146,43,78,35,144,179,34,36,17,35,75,324
Maryland-Baltimore County5,5,Jourdan Grant,SR,G,Maryland-Baltimore County,AEC,32,766,81,201,46,106,35,95,45,67,15,60,75,84,22,7,58,57,242
Maryland-Baltimore County6,6,Daniel Akin,FR,F,Maryland-Baltimore County,AEC,34,569,46,70,46,70,0,0,29,69,45,70,115,11,11,8,34,75,121
Maryland-Baltimore County7,7,Nolan Gerrity,JR,C,Maryland-Baltimore County,AEC,33,431,46,94,46,94,0,0,8,27,41,64,105,23,9,16,22,53,100
Maryland-Baltimore County8,8,Max Curran,SO,F,Maryland-Baltimore County,AEC,26,311,46,105,33,52,13,53,19,36,22,62,84,6,2,7,16,51,124
Maryland-Baltimore County9,9,Brandon Horvath,FR,F,Maryland-Baltimore County,AEC,30,311,38,88,22,33,16,55,11,27,17,46,63,12,8,5,11,18,103
Maryland-Baltimore County10,10,Max Portmann,JR,F,Maryland-Baltimore County,AEC,20,229,33,68,31,63,2,5,18,28,18,21,39,3,3,7,16,39,86
Maryland-Baltimore County11,11,Ishmail Jabbie,JR,G,Maryland-Baltimore County,AEC,17,124,13,30,7,14,6,16,10,13,7,13,20,6,7,1,13,12,42
Maryland-Baltimore County12,12,Josh Rosario,FR,G,Maryland-Baltimore County,AEC,13,73,5,26,2,11,3,15,8,11,1,6,7,9,4,0,10,7,21
Maryland-Baltimore County13,13,David Park,,G,Maryland-Baltimore County,AEC,4,5,1,1,1,1,0,0,0,0,0,0,0,0,0,0,0,0,2
Maryland-Baltimore County14,14,Isiah Rogers,,G,Maryland-Baltimore County,AEC,1,1,0,1,0,0,0,1,0,0,0,0,0,0,0,0,0,0,0
Maryland-Eastern Shore1,1,Ahmad Frost,SO,G,Maryland-Eastern Shore,MEAC,32,1069,124,343,64,153,60,190,38,57,23,73,96,76,41,0,71,87,346
Maryland-Eastern Shore2,2,Logan McIntosh,SR,G,Maryland-Eastern Shore,MEAC,29,1032,111,291,84,199,27,92,97,129,19,96,115,133,29,2,84,44,346
Maryland-Eastern Shore3,3,Tyler Jones,SO,F,Maryland-Eastern Shore,MEAC,32,941,142,340,120,248,22,92,81,113,51,109,160,20,13,20,53,75,387
Maryland-Eastern Shore4,4,Cameron Bacote,FR,G,Maryland-Eastern Shore,MEAC,32,849,85,235,40,84,45,151,15,19,10,48,58,62,15,0,43,30,230
Maryland-Eastern Shore5,5,Miryne Thomas,FR,F,Maryland-Eastern Shore,MEAC,29,764,116,265,108,214,8,51,83,127,72,154,226,25,17,11,73,99,323
Maryland-Eastern Shore6,6,Colen Gaynor,FR,G,Maryland-Eastern Shore,MEAC,27,621,54,135,36,77,18,58,19,36,43,76,119,8,18,7,29,69,145
Maryland-Eastern Shore7,7,LeAndre Thomas,FR,F,Maryland-Eastern Shore,MEAC,32,453,39,102,39,102,0,0,21,41,43,58,101,3,7,15,27,98,99
Maryland-Eastern Shore8,8,Sean Hoggs,FR,G,Maryland-Eastern Shore,MEAC,32,442,29,95,7,21,22,74,8,13,8,33,41,14,7,1,18,20,88
Maryland-Eastern Shore9,9,Najee Fitzgerald,SR,G,Maryland-Eastern Shore,MEAC,21,98,2,5,2,4,0,1,3,5,5,7,12,3,1,0,5,13,7
Maryland-Eastern Shore10,10,Montraz Oliver,FR,G,Maryland-Eastern Shore,MEAC,15,66,5,23,3,14,2,9,1,2,4,8,12,1,0,1,3,5,13
Maryland-Eastern Shore11,11,Micheal Odiana,FR,G,Maryland-Eastern Shore,MEAC,18,65,3,10,1,3,2,7,0,0,2,1,3,2,3,0,2,8,8
Massachusetts1,1,C.J. Anderson,SR,G,Massachusetts,A-10,32,1126,115,278,83,198,32,80,78,96,29,132,161,165,22,5,76,77,340
Massachusetts2,2,Luwane Pipkins,SO,G,Massachusetts,A-10,32,1114,228,530,121,279,107,251,115,146,15,99,114,128,48,0,108,68,678
Massachusetts3,3,Carl Pierre,FR,G,Massachusetts,A-10,33,1031,141,318,49,123,92,195,36,44,9,64,73,35,21,9,32,69,410
Massachusetts4,4,Malik Hines,JR,F,Massachusetts,A-10,33,892,121,184,121,184,0,0,54,74,76,127,203,26,14,28,56,89,296
Massachusetts5,5,Unique McLean,FR,G,Massachusetts,A-10,33,859,74,201,60,149,14,52,18,31,48,114,162,59,24,13,40,85,180
Massachusetts6,6,Rayshawn Miller,JR,G,Massachusetts,A-10,33,820,61,169,30,70,31,99,12,17,7,46,53,64,13,2,35,51,165
Massachusetts7,7,Chris Baldwin,SO,F,Massachusetts,A-10,21,350,39,94,23,46,16,48,7,11,23,64,87,13,7,10,22,54,101
Massachusetts8,8,Rashaan Holloway,JR,C,Massachusetts,A-10,15,270,63,101,63,101,0,0,23,37,26,47,73,4,5,26,27,49,149
Massachusetts9,9,Khalea Turner-Morris,FR,C,Massachusetts,A-10,24,150,11,18,11,18,0,0,9,15,12,20,32,3,0,2,10,30,31
Massachusetts10,10,Randall West,,F,Massachusetts,A-10,8,92,6,14,6,14,0,0,5,8,12,15,27,3,3,3,1,14,17
Massachusetts11,11,Jaylen Franklin,SO,G,Massachusetts,A-10,14,40,2,10,1,4,1,6,0,0,0,3,3,5,2,0,1,8,5
Massachusetts12,12,Mike Gillespie,FR,G,Massachusetts,A-10,4,6,0,1,0,0,0,1,2,2,0,3,3,0,0,0,0,1,2
Massachusetts-Lowell1,1,Jahad Thomas,SR,G,Massachusetts-Lowell,AEC,27,979,211,410,195,366,16,44,132,189,69,157,226,107,48,8,95,70,570
Massachusetts-Lowell2,2,Ryan Jones,JR,G,Massachusetts-Lowell,AEC,30,947,114,254,71,141,43,113,69,99,22,117,139,91,19,5,68,48,340
Massachusetts-Lowell3,3,Matt Harris,SR,G,Massachusetts-Lowell,AEC,30,939,109,277,36,80,73,197,78,90,10,89,99,23,26,2,50,72,369
Massachusetts-Lowell4,4,Josh Gantz,JR,F,Massachusetts-Lowell,AEC,30,906,95,195,64,104,31,91,32,43,34,92,126,69,39,32,49,104,253
Massachusetts-Lowell5,5,Rinardo Perry,SO,G,Massachusetts-Lowell,AEC,29,727,101,224,74,132,27,92,35,61,22,51,73,44,30,9,36,54,264
Massachusetts-Lowell6,6,Obadiah Noel,FR,G,Massachusetts-Lowell,AEC,30,552,58,145,40,97,18,48,62,91,28,47,75,34,19,11,33,65,196
Massachusetts-Lowell7,7,Shawn Jones,JR,G,Massachusetts-Lowell,AEC,28,408,35,98,30,75,5,23,39,49,16,18,34,45,16,3,30,41,114
Massachusetts-Lowell8,8,Connor Bennett,SO,F,Massachusetts-Lowell,AEC,25,285,41,61,41,61,0,0,19,25,27,29,56,9,4,9,11,31,101
Massachusetts-Lowell9,9,Stefan Borovac,SO,F,Massachusetts-Lowell,AEC,19,172,17,31,16,24,1,7,8,21,7,26,33,10,6,2,16,32,43
Massachusetts-Lowell10,10,Joey Naccarato,FR,G,Massachusetts-Lowell,AEC,13,68,5,15,4,9,1,6,14,19,4,7,11,3,0,0,4,8,25
Massachusetts-Lowell11,11,Dontavious Smith,JR,F,Massachusetts-Lowell,AEC,8,42,5,9,5,9,0,0,1,3,6,9,15,0,2,5,7,13,11
McNeese State1,1,Jarren Greenwood,JR,G,McNeese State,Southland,28,955,112,263,80,166,32,97,98,118,10,97,107,90,22,3,65,50,354
McNeese State2,2,James Harvey,JR,G,McNeese State,Southland,29,889,100,251,33,72,67,179,35,47,12,46,58,43,14,4,49,37,302
McNeese State3,3,Quatarrius Wilson,JR,F,McNeese State,Southland,29,868,125,247,119,222,6,25,56,91,105,192,297,39,22,28,67,69,312
McNeese State4,4,Kalob Ledoux,SO,G,McNeese State,Southland,28,832,151,357,90,190,61,167,51,63,20,102,122,29,13,4,65,65,414
McNeese State5,5,Stephen Ugochukwu,SR,F,McNeese State,Southland,28,639,86,198,85,194,1,4,52,85,46,102,148,24,15,35,40,86,225
McNeese State6,6,Jacob Ledoux,SO,G,McNeese State,Southland,29,561,81,187,57,118,24,69,50,68,13,62,75,56,34,2,52,41,236
McNeese State7,7,LaBarrius Hill,SR,F,McNeese State,Southland,27,473,46,77,45,73,1,4,19,27,40,63,103,16,11,43,18,73,112
McNeese State8,8,Richard Laku,SO,F,McNeese State,Southland,22,163,19,53,8,20,11,33,9,12,8,17,25,5,2,7,6,24,58
McNeese State9,9,Adrian Brown,JR,F,McNeese State,Southland,26,142,16,40,16,39,0,1,12,19,8,23,31,4,4,4,7,19,44
McNeese State10,10,Demarco Owens,JR,PF,McNeese State,Southland,19,135,20,49,20,47,0,2,17,32,14,23,37,7,4,1,18,18,57
McNeese State11,11,Kelvin Henry Jr.,FR,G,McNeese State,Southland,14,95,5,16,5,13,0,3,11,15,2,6,8,9,5,1,8,11,21
McNeese State12,12,Myles Hutchinson,FR,PG,McNeese State,Southland,13,46,8,22,6,14,2,8,7,8,6,1,7,5,6,1,8,7,25
McNeese State13,13,Fred Haywood,FR,SF,McNeese State,Southland,13,28,7,13,7,12,0,1,2,5,5,4,9,0,4,0,0,3,16
McNeese State14,14,Jacob Bonnington,FR,PF,McNeese State,Southland,7,24,4,14,4,10,0,4,0,0,3,5,8,0,0,0,2,2,8
Memphis1,1,Kyvon Davenport,JR,F,Memphis,AAC,34,995,153,300,114,190,39,110,106,153,71,138,209,27,21,42,56,95,451
Memphis2,2,Jeremiah Martin,JR,G,Memphis,AAC,27,936,157,354,106,198,51,156,145,185,20,93,113,103,62,16,72,52,510
Memphis3,3,Jamal Johnson,FR,G,Memphis,AAC,34,900,70,200,23,59,47,141,46,66,25,86,111,35,22,15,32,64,233
Memphis4,4,Kareem Brewton Jr.,JR,G,Memphis,AAC,34,832,115,272,96,189,19,83,60,92,32,59,91,80,30,2,71,70,309
Memphis5,5,Jimario Rivers,SR,G,Memphis,AAC,32,761,80,165,75,150,5,15,55,76,45,70,115,60,19,17,58,84,220
Memphis6,6,Mike Parks Jr.,JR,F,Memphis,AAC,34,754,116,209,114,202,2,7,42,60,67,87,154,22,9,23,48,66,276
Memphis7,7,Raynere Thornton,JR,F,Memphis,AAC,34,702,59,129,39,76,20,53,46,84,37,95,132,40,21,4,38,54,184
Memphis8,8,David Nickelberry,FR,G,Memphis,AAC,33,360,37,91,29,59,8,32,9,16,13,43,56,31,12,5,31,28,91
Memphis9,9,Victor Enoh,FR,F,Memphis,AAC,34,301,16,36,16,36,0,0,22,39,22,34,56,7,1,2,17,37,54
Memphis10,10,Malik Rhodes,JR,G,Memphis,AAC,26,264,18,54,8,17,10,37,19,24,1,9,10,32,4,0,21,23,65
Memphis11,11,Karim Sameh Azab,,F,Memphis,AAC,15,84,7,21,7,21,0,0,1,3,1,10,11,5,1,2,4,9,15
Memphis12,12,Alex Moffatt,,F,Memphis,AAC,2,7,0,1,0,1,0,0,0,0,0,0,0,0,0,0,1,1,0
Memphis13,13,Evin Olds,,G,Memphis,AAC,2,2,0,0,0,0,0,0,0,0,0,0,0,0,0,0,0,0,0
Memphis14,14,Jesse Johnson,,F,Memphis,AAC,1,2,0,0,0,0,0,0,0,0,0,0,0,0,0,0,0,0,0
Mercer1,1,Jordan Strawberry,SR,G,Mercer,Southern,32,974,106,297,59,150,47,147,95,110,20,95,115,156,22,2,53,46,354
Mercer2,2,Demetre Rivers,SR,G,Mercer,Southern,32,910,118,230,77,115,41,115,76,85,31,69,100,32,16,7,42,57,353
Mercer3,3,Stephon Jelks,SR,F,Mercer,Southern,32,834,112,212,68,116,44,96,48,62,57,175,232,52,23,13,39,78,316
Mercer4,4,Desmond Ringer,SR,F,Mercer,Southern,32,805,111,184,110,181,1,3,68,82,64,109,173,16,9,11,52,83,291
Mercer5,5,Ria'n Holland,,G,Mercer,Southern,17,495,100,205,52,102,48,103,56,67,12,39,51,43,27,1,24,31,304
Mercer6,6,Cory Kilby,JR,F,Mercer,Southern,32,493,44,98,21,37,23,61,18,27,17,59,76,21,8,6,16,41,129
Mercer7,7,Marcus Cohen,FR,G,Mercer,Southern,32,479,61,133,60,127,1,6,21,52,6,35,41,83,17,1,62,44,144
Mercer8,8,Ross Cummings,SO,G,Mercer,Southern,25,435,67,156,18,39,49,117,28,38,4,34,38,13,8,1,14,30,211
Mercer9,9,Jaylen Stowe,JR,G,Mercer,Southern,32,422,36,77,35,69,1,8,25,44,25,67,92,17,19,3,28,57,98
Mercer10,10,Ethan Stair,SO,G,Mercer,Southern,20,353,43,91,31,59,12,32,20,28,11,38,49,25,15,1,30,36,118
Mercer11,11,Ryan Johnson,JR,G,Mercer,Southern,27,208,18,38,12,21,6,17,25,38,12,25,37,10,10,3,14,24,67
Mercer12,12,Mason Green,FR,F,Mercer,Southern,16,58,8,11,8,11,0,0,4,7,7,4,11,1,2,3,5,9,20
Mercer13,13,Mac Brydon,FR,C,Mercer,Southern,12,34,3,4,3,4,0,0,5,7,3,4,7,1,0,1,1,3,11
Miami (FL)1,1,Anthony Lawrence Jr.,JR,G,Miami (FL),ACC,31,952,98,211,60,123,38,88,43,63,44,161,205,73,44,31,51,76,277
Miami (FL)2,2,Lonnie Walker,FR,G,Miami (FL),ACC,31,850,127,306,73,150,54,156,48,64,13,68,81,61,30,14,34,50,356
Miami (FL)3,3,Ja'Quan Newton,,G,Miami (FL),ACC,31,817,104,237,97,210,7,27,56,91,15,61,76,83,29,4,57,48,271
Miami (FL)4,4,Dewan Huell,SO,F,Miami (FL),ACC,31,800,142,248,142,245,0,3,70,100,64,142,206,13,16,28,42,60,354
Miami (FL)5,5,Dejan Vasiljevic,SO,G,Miami (FL),ACC,31,709,100,226,34,64,66,162,14,16,14,61,75,13,13,2,16,49,280
Miami (FL)6,6,Chris Lykes,FR,G,Miami (FL),ACC,31,660,97,238,50,101,47,137,56,78,2,31,33,73,23,1,57,67,297
Miami (FL)7,7,Bruce Brown,SO,G,Miami (FL),ACC,19,640,78,188,62,128,16,60,44,70,25,110,135,76,25,15,43,43,216
Miami (FL)8,8,Ebuka Izundu,JR,C,Miami (FL),ACC,31,452,71,101,71,101,0,0,13,29,53,62,115,7,14,19,25,73,155
Miami (FL)9,9,Sam Waardenburg,FR,F,Miami (FL),ACC,20,295,24,58,10,26,14,32,7,9,25,32,57,13,9,8,13,31,69
Miami (FL)10,10,Rodney Miller,SO,C,Miami (FL),ACC,15,52,8,14,8,14,0,0,2,12,3,4,7,0,0,1,3,7,18
Miami (FL)11,11,Mike Robinson,JR,G,Miami (FL),ACC,7,12,1,4,0,1,1,3,0,0,0,0,0,1,0,0,0,1,3
Miami (FL)12,12,Josh Heath,,F,Miami (FL),ACC,7,11,0,1,0,0,0,1,1,2,0,1,1,0,0,0,0,0,1
Miami (OH)1,1,Nike Sibande,FR,G,Miami (OH),MAC,33,1082,160,396,90,186,70,210,96,131,28,116,144,42,39,5,70,61,486
Miami (OH)2,2,Darrian Ringo,JR,G,Miami (OH),MAC,33,1017,113,245,84,152,29,93,69,96,23,94,117,229,89,3,108,89,324
Miami (OH)3,3,Jalen Adaway,FR,G,Miami (OH),MAC,31,902,102,209,84,141,18,68,45,64,42,116,158,29,19,5,42,47,267
Miami (OH)4,4,Logan McLane,SR,F,Miami (OH),MAC,33,760,124,240,113,196,11,44,35,72,50,129,179,23,31,26,52,63,294
Miami (OH)5,5,Dalonte Brown,FR,F,Miami (OH),MAC,33,730,104,240,76,160,28,80,35,58,36,144,180,11,14,22,40,85,271
Miami (OH)6,6,Rod Mills,SR,F,Miami (OH),MAC,33,588,53,153,31,84,22,69,13,17,22,70,92,18,13,8,24,45,141
Miami (OH)7,7,Isaiah Coleman-Lands,FR,G,Miami (OH),MAC,33,574,61,146,21,46,40,100,15,23,17,43,60,63,21,2,41,52,177
Miami (OH)8,8,Bam Bowman,SO,F,Miami (OH),MAC,33,513,76,169,57,103,19,66,40,52,39,78,117,11,11,9,29,66,211
Miami (OH)9,9,Jake Wright,JR,G,Miami (OH),MAC,30,479,51,127,4,11,47,116,9,12,1,31,32,9,11,1,9,23,158
Miami (OH)10,10,Precious Ayah,FR,F,Miami (OH),MAC,14,59,3,12,3,11,0,1,9,10,7,11,18,3,3,5,4,14,15
Miami (OH)11,11,Darius Harper,,C,Miami (OH),MAC,6,23,2,3,2,3,0,0,0,0,1,3,4,0,0,0,2,8,4
Miami (OH)12,12,Michael Ritchie,FR,F,Miami (OH),MAC,7,13,1,3,0,1,1,2,1,2,2,0,2,2,0,0,1,2,4
Miami (OH)13,13,Grant Pitman,JR,G,Miami (OH),MAC,6,10,3,4,0,1,3,3,1,2,3,2,5,0,1,0,0,0,10
Michigan1,1,Muhammad-Ali Abdur-Rahkman,SR,G,Michigan,Big Ten,35,1218,150,340,86,180,64,160,78,103,24,111,135,116,31,6,23,57,442
Michigan2,2,Charles Matthews,JR,G,Michigan,Big Ten,35,1035,169,343,139,255,30,88,74,132,49,140,189,91,23,22,72,71,442
Michigan3,3,Duncan Robinson,SR,G,Michigan,Big Ten,35,903,109,245,40,68,69,177,48,54,19,73,92,40,23,13,21,77,335
Michigan4,4,Zavier Simpson,SO,G,Michigan,Big Ten,35,900,99,206,77,135,22,71,42,81,13,94,107,127,41,1,46,46,262
Michigan5,5,Moritz Wagner,JR,F,Michigan,Big Ten,33,899,182,344,129,210,53,134,63,90,46,188,234,25,31,19,42,100,480
Michigan6,6,Isaiah Livers,FR,F,Michigan,Big Ten,34,517,53,104,32,52,21,52,6,10,31,46,77,16,10,11,22,40,133
Michigan7,7,Jon Teske,SO,C,Michigan,Big Ten,35,450,50,92,50,91,0,1,27,49,51,70,121,13,21,22,13,58,127
Michigan8,8,Jordan Poole,FR,G,Michigan,Big Ten,32,424,67,157,31,60,36,97,37,45,3,43,46,20,17,6,25,34,207
Michigan9,9,Eli Brooks,FR,G,Michigan,Big Ten,27,298,18,62,8,21,10,41,8,13,8,24,32,29,12,3,13,16,54
Michigan10,10,Jaaron Simmons,SR,G,Michigan,Big Ten,27,220,14,39,9,23,5,16,8,13,4,16,20,31,2,0,18,22,41
Michigan11,11,Ibi Watson,SO,G,Michigan,Big Ten,22,123,19,47,10,20,9,27,6,11,10,8,18,8,6,1,4,5,53
Michigan12,12,Austin Davis,SO,F,Michigan,Big Ten,13,49,8,13,8,13,0,0,1,3,7,14,21,0,1,6,3,15,17
Michigan13,13,Brent Hibbitts,JR,F,Michigan,Big Ten,5,15,3,5,2,4,1,1,2,2,2,1,3,1,0,1,1,2,9
Michigan14,14,Luke Wilson,FR,G,Michigan,Big Ten,2,7,0,1,0,0,0,1,0,1,0,0,0,0,0,0,1,1,0
Michigan15,15,Naji Ozeir,FR,F,Michigan,Big Ten,2,7,1,2,1,2,0,0,0,0,0,1,1,0,1,0,0,1,2
Michigan16,16,C.J. Baird,FR,F,Michigan,Big Ten,2,7,1,2,1,1,0,1,0,0,0,0,0,1,0,0,1,0,2
Michigan17,17,Rico Ozuna-Harrison,,G,Michigan,Big Ten,1,3,0,1,0,0,0,1,0,0,0,1,1,0,0,0,0,0,0
Michigan State1,1,Miles Bridges,SO,G,Michigan State,Big Ten,32,997,193,417,128,241,65,176,91,103,37,185,222,88,21,26,66,50,542
Michigan State2,2,Cassius Winston,SO,G,Michigan State,Big Ten,33,917,136,262,65,127,71,135,73,82,6,108,114,225,20,2,82,66,416
Michigan State3,3,Joshua Langford,SO,G,Michigan State,Big Ten,33,885,144,332,102,233,42,99,55,65,23,70,93,52,12,2,48,76,385
Michigan State4,4,Jaren Jackson Jr.,FR,F,Michigan State,Big Ten,33,731,117,225,79,129,38,96,102,128,47,144,191,38,21,104,60,106,374
Michigan State5,5,Matt McQuaid,JR,G,Michigan State,Big Ten,33,684,66,156,15,32,51,124,23,27,23,41,64,43,11,3,25,54,206
Michigan State6,6,Nick Ward,SO,F,Michigan State,Big Ten,33,629,154,235,153,234,1,1,108,174,91,148,239,17,9,46,53,77,417
Michigan State7,7,Lourawls Nairn,SR,G,Michigan State,Big Ten,33,571,27,54,22,38,5,16,1,5,0,31,31,99,8,2,29,33,60
Michigan State8,8,Kenny Goins,JR,F,Michigan State,Big Ten,29,421,27,58,23,43,4,15,7,11,25,63,88,36,12,22,14,30,65
Michigan State9,9,Gavin Schilling,SR,F,Michigan State,Big Ten,33,327,36,51,36,51,0,0,28,48,40,76,116,12,8,12,21,51,100
Michigan State10,10,Xavier Tillman,FR,F,Michigan State,Big Ten,33,264,34,52,34,52,0,0,20,29,25,50,75,10,8,20,13,29,88
Michigan State11,11,Ben Carter,SR,F,Michigan State,Big Ten,21,145,6,15,6,14,0,1,1,4,5,18,23,18,2,4,8,18,13
Michigan State12,12,Conner George,SO,G,Michigan State,Big Ten,16,54,3,15,3,7,0,8,0,2,7,11,18,0,3,0,2,6,6
Middle Tennessee1,1,Nick King,SR,F,Middle Tennessee,CUSA,31,1022,243,494,204,392,39,102,129,175,73,187,260,59,22,6,87,47,654
Middle Tennessee2,2,Giddy Potts,SR,G,Middle Tennessee,CUSA,31,983,129,318,52,126,77,192,68,79,15,120,135,57,44,8,52,81,403
Middle Tennessee3,3,Tyrik Dixon,SO,G,Middle Tennessee,CUSA,30,687,51,133,30,71,21,62,27,34,13,79,92,98,27,2,38,83,150
Middle Tennessee4,4,Brandon Walters,SR,F,Middle Tennessee,CUSA,30,684,129,201,128,197,1,4,57,82,78,80,158,19,19,25,39,109,316
Middle Tennessee5,5,Antwain Johnson,JR,G,Middle Tennessee,CUSA,29,648,102,236,63,136,39,100,52,61,13,42,55,52,20,4,28,55,295
Middle Tennessee6,6,David Simmons,JR,G,Middle Tennessee,CUSA,31,564,53,101,47,82,6,19,35,55,26,56,82,50,16,3,34,78,147
Middle Tennessee7,7,Edward Simpson,SR,G,Middle Tennessee,CUSA,31,563,26,73,4,12,22,61,3,4,5,45,50,45,13,1,20,44,77
Middle Tennessee8,8,Karl Gamble,JR,F,Middle Tennessee,CUSA,31,451,48,94,46,86,2,8,23,38,41,57,98,7,9,12,24,55,121
Middle Tennessee9,9,James Hawthorne,JR,F,Middle Tennessee,CUSA,30,242,27,67,26,55,1,12,15,22,17,22,39,9,5,4,16,27,70
Middle Tennessee10,10,Donovan Sims,FR,G,Middle Tennessee,CUSA,26,226,12,27,4,9,8,18,7,8,1,28,29,33,12,3,14,16,39
Middle Tennessee11,11,Therren Shelton-Szmidt,FR,G,Middle Tennessee,CUSA,24,127,12,38,3,12,9,26,0,1,6,12,18,8,6,0,9,10,33
Middle Tennessee12,12,Davion Thomas,FR,F,Middle Tennessee,CUSA,12,36,5,13,5,10,0,3,2,2,2,2,4,0,1,1,4,6,12
Middle Tennessee13,13,Chase Miller,SO,G,Middle Tennessee,CUSA,8,13,1,7,0,2,1,5,0,2,0,0,0,0,0,0,0,2,3
Middle Tennessee14,14,Will Slatten,FR,G,Middle Tennessee,CUSA,2,2,0,1,0,1,0,0,0,0,2,0,2,0,0,0,0,0,0
Milwaukee1,1,Brock Stull,JR,G,Milwaukee,Horizon,31,1114,139,367,67,177,72,190,64,86,17,133,150,97,20,3,68,47,414
Milwaukee2,2,Brett Prahl,SR,F,Milwaukee,Horizon,33,981,130,209,126,193,4,16,46,65,58,107,165,44,18,46,62,66,310
Milwaukee3,3,Jeremiah Bell,JR,G,Milwaukee,Horizon,32,975,157,371,82,175,75,196,63,83,10,92,102,57,38,3,44,74,452
Milwaukee4,4,Bryce Nze,SO,F,Milwaukee,Horizon,33,972,147,255,139,226,8,29,38,79,96,184,280,43,28,48,70,96,340
Milwaukee5,5,Bryce Barnes,SO,G,Milwaukee,Horizon,32,665,71,196,51,126,20,70,46,68,9,60,69,56,28,3,45,65,208
Milwaukee6,6,August Haas,SO,G,Milwaukee,Horizon,32,644,44,113,32,69,12,44,23,42,1,64,65,89,27,3,41,64,123
Milwaukee7,7,Vance Johnson,JR,F,Milwaukee,Horizon,33,481,56,112,53,100,3,12,36,52,41,79,120,8,7,12,36,62,151
Milwaukee8,8,Carson Warren-Newsome,FR,G,Milwaukee,Horizon,27,433,54,148,31,65,23,83,32,41,11,40,51,20,19,2,21,30,163
Milwaukee9,9,Jeremy Johnson,SO,G,Milwaukee,Horizon,18,345,35,96,18,33,17,63,3,6,7,37,44,15,11,5,8,38,90
Milwaukee10,10,Alex Prahl,SR,F,Milwaukee,Horizon,11,20,0,2,0,2,0,0,3,4,0,6,6,0,0,0,0,2,3
Milwaukee11,11,Seth Dittmer,SO,F,Milwaukee,Horizon,7,12,0,0,0,0,0,0,2,2,2,3,5,0,0,0,0,1,2
Milwaukee12,12,Sam Burkart,SO,G,Milwaukee,Horizon,6,8,1,3,0,2,1,1,0,0,0,0,0,0,0,0,0,0,3
Minnesota1,1,Nate Mason,SR,G,Minnesota,Big Ten,31,1057,168,428,91,231,77,197,104,134,18,95,113,130,34,2,47,60,517
Minnesota2,2,Jordan Murphy,JR,F,Minnesota,Big Ten,32,1019,202,385,191,350,11,35,123,176,129,232,361,45,39,32,83,81,538
Minnesota3,3,Dupree McBrayer,JR,G,Minnesota,Big Ten,27,773,82,230,46,125,36,105,53,78,4,52,56,66,26,9,33,48,253
Minnesota4,4,Isaiah Washington,FR,G,Minnesota,Big Ten,32,641,102,279,81,192,21,87,52,68,19,65,84,75,18,2,48,38,277
Minnesota5,5,Michael Hurt,SO,F,Minnesota,Big Ten,32,608,35,79,26,58,9,21,24,36,10,71,81,30,9,14,23,30,103
Minnesota6,6,Amir Coffey,SO,G,Minnesota,Big Ten,18,569,87,183,66,126,21,57,57,83,17,56,73,60,13,5,35,36,252
Minnesota7,7,Reggie Lynch,SR,C,Minnesota,Big Ten,16,422,59,101,59,101,0,0,43,60,50,78,128,21,11,66,23,43,161
Minnesota8,8,Davonte Fitzgerald,SR,F,Minnesota,Big Ten,31,413,43,108,28,64,15,44,13,24,14,61,75,10,9,12,13,49,114
Minnesota9,9,Bakary Konate,SR,C,Minnesota,Big Ten,28,410,20,38,20,38,0,0,9,14,36,61,97,8,11,15,15,61,49
Minnesota10,10,Jamir Harris,FR,G,Minnesota,Big Ten,28,393,38,108,10,27,28,81,6,12,5,19,24,17,7,1,15,25,110
Minnesota11,11,Gaston Diedhiou,SR,F,Minnesota,Big Ten,16,153,12,27,12,27,0,0,3,7,5,15,20,4,4,5,2,20,27
Minnesota12,12,Brady Rudrud,SO,G,Minnesota,Big Ten,6,14,1,3,1,1,0,2,0,0,0,2,2,1,0,0,3,1,2
Minnesota13,13,Conroy Hunt,FR,G,Minnesota,Big Ten,2,3,1,2,1,1,0,1,0,0,0,1,1,0,0,0,0,0,2
Mississippi1,1,Markel Crawford,SR,G,Mississippi,SEC,32,989,97,248,67,141,30,107,71,93,18,110,128,68,38,7,36,63,295
Mississippi2,2,Deandre Burnett,SR,G,Mississippi,SEC,31,877,116,308,61,155,55,153,133,166,10,53,63,121,19,0,66,31,420
Mississippi3,3,Terence Davis,JR,G,Mississippi,SEC,32,873,157,386,98,200,59,186,67,93,47,151,198,67,29,28,72,94,440
Mississippi4,4,Breein Tyree,SO,G,Mississippi,SEC,32,789,122,310,75,178,47,132,56,80,11,58,69,90,22,9,57,64,347
Mississippi5,5,Bruce Stevens,JR,F,Mississippi,SEC,32,715,121,235,107,184,14,51,89,117,60,111,171,38,16,16,34,95,345
Mississippi6,6,Marcanvis Hymon,SR,F,Mississippi,SEC,32,624,60,107,60,107,0,0,22,46,58,101,159,25,14,26,24,94,142
Mississippi7,7,Devontae Shuler,FR,G,Mississippi,SEC,32,604,74,210,44,94,30,116,15,20,26,61,87,33,32,3,26,33,193
Mississippi8,8,Justas Furmanavicius,SR,F,Mississippi,SEC,32,538,33,77,18,38,15,39,20,28,45,52,97,12,15,22,14,59,101
Mississippi9,9,Dominik Olejniczak,SO,C,Mississippi,SEC,32,466,60,113,60,113,0,0,18,28,38,45,83,13,14,20,29,76,138
Mississippi10,10,D.C. Davis,,G,Mississippi,SEC,4,15,1,2,0,0,1,2,2,4,0,1,1,1,1,0,2,0,5
Mississippi11,11,Ilya Tyrtyshnik,FR,G,Mississippi,SEC,3,5,0,3,0,1,0,2,0,0,0,2,2,0,0,0,1,0,0
Mississippi12,12,Lane Below,,G,Mississippi,SEC,2,2,0,0,0,0,0,0,0,0,0,0,0,0,0,0,0,0,0
Mississippi13,13,Eric Horn,,F,Mississippi,SEC,2,2,0,0,0,0,0,0,0,0,0,1,1,0,0,0,0,0,0
Mississippi14,14,Antonio Morgano,,G,Mississippi,SEC,1,1,0,0,0,0,0,0,0,0,0,0,0,0,0,0,1,0,0
Mississippi State1,1,Quinndary Weatherspoon,JR,G,Mississippi State,SEC,33,1037,173,355,135,233,38,122,104,137,52,139,191,117,49,12,88,79,488
Mississippi State2,2,Nick Weatherspoon,FR,G,Mississippi State,SEC,33,938,138,289,113,202,25,87,65,90,8,88,96,67,31,5,33,57,366
Mississippi State3,3,Abdul Ado,FR,F,Mississippi State,SEC,32,852,97,150,97,150,0,0,50,98,88,119,207,11,27,60,67,86,244
Mississippi State4,4,Lamar Peters,SO,G,Mississippi State,SEC,30,811,110,290,67,134,43,156,41,63,10,59,69,119,45,9,81,61,304
Mississippi State5,5,Aric Holman,JR,F,Mississippi State,SEC,33,754,125,220,92,142,33,78,65,90,65,153,218,23,17,57,41,63,348
Mississippi State6,6,Tyson Carter,SO,G,Mississippi State,SEC,33,746,97,240,47,89,50,151,34,41,6,55,61,42,22,1,32,31,278
Mississippi State7,7,Xavian Stapleton,JR,G,Mississippi State,SEC,28,537,61,167,36,87,25,80,20,25,17,52,69,16,19,9,25,68,167
Mississippi State8,8,Eli Wright,SO,G,Mississippi State,SEC,30,429,39,93,33,66,6,27,14,22,25,42,67,27,7,7,19,36,98
Mississippi State9,9,E.J. Datcher,SO,C,Mississippi State,SEC,28,234,25,41,25,41,0,0,17,24,17,34,51,4,3,8,12,45,67
Mississippi State10,10,KeyShawn Feazell,FR,F,Mississippi State,SEC,24,146,16,35,15,26,1,9,1,4,8,25,33,1,2,2,9,14,34
Mississippi State11,11,Schnider Herard,SO,C,Mississippi State,SEC,11,88,4,15,4,15,0,0,3,7,11,12,23,0,0,8,11,12,11
Mississippi State12,12,Nick Singleton,JR,G,Mississippi State,SEC,8,24,9,13,5,6,4,7,0,1,2,3,5,1,0,0,2,0,22
Mississippi State13,13,Mitchell Storm,SO,F,Mississippi State,SEC,7,19,0,4,0,2,0,2,0,0,2,4,6,0,0,0,1,1,0
Mississippi State14,14,Drew Davis,SR,G,Mississippi State,SEC,8,17,1,9,1,5,0,4,1,2,0,2,2,2,0,0,2,1,3
Mississippi State15,15,T.J. Gray,SO,G,Mississippi State,SEC,4,10,1,3,0,0,1,3,0,0,0,0,0,0,0,0,1,3,3
Mississippi State16,16,Tate Clayton,FR,G,Mississippi State,SEC,4,9,0,0,0,0,0,0,0,0,0,0,0,0,0,0,0,0,0
Mississippi Valley State1,1,Jordan Evans,JR,SG,Mississippi Valley State,SWAC,32,960,158,431,102,269,56,162,97,130,28,69,97,64,33,1,63,93,469
Mississippi Valley State2,2,Dante Scott,,SF,Mississippi Valley State,SWAC,30,948,162,386,118,267,44,119,79,102,51,116,167,57,15,9,76,74,447
Mississippi Valley State3,3,Nate Nahimy,JR,PG,Mississippi Valley State,SWAC,30,578,48,141,33,74,15,67,16,25,5,37,42,41,22,1,33,39,127
Mississippi Valley State4,4,Arinze Anakwenze,JR,F,Mississippi Valley State,SWAC,32,525,52,108,52,104,0,4,15,32,36,58,94,15,13,16,32,76,119
Mississippi Valley State5,5,Emmanuel Ejeh,JR,C,Mississippi Valley State,SWAC,32,516,60,118,60,116,0,2,28,41,69,111,180,12,10,15,27,71,148
Mississippi Valley State6,6,Lorenzo Hunt,SO,SF,Mississippi Valley State,SWAC,31,506,50,127,44,108,6,19,22,35,25,45,70,18,18,6,31,51,128
Mississippi Valley State7,7,Kylan Phillips,,G,Mississippi Valley State,SWAC,23,483,39,117,33,95,6,22,15,22,12,46,58,31,18,0,22,40,99
Mississippi Valley State8,8,Gemaal Davis,JR,SF,Mississippi Valley State,SWAC,31,416,55,152,47,129,8,23,47,67,28,47,75,15,12,1,24,25,165
Mississippi Valley State9,9,LaCurtis Allen,SR,SF,Mississippi Valley State,SWAC,30,374,24,53,24,53,0,0,14,32,24,21,45,10,10,0,18,59,62
Mississippi Valley State10,10,Tereke Eckwood,JR,PG,Mississippi Valley State,SWAC,14,300,32,98,25,73,7,25,21,26,6,31,37,26,13,1,21,19,92
Mississippi Valley State11,11,Jeffery Lewis,FR,G,Mississippi Valley State,SWAC,24,283,26,90,10,25,16,65,2,4,8,22,30,12,6,0,22,22,70
Mississippi Valley State12,12,Davere Creighton,JR,F,Mississippi Valley State,SWAC,27,210,19,71,11,33,8,38,19,31,13,31,44,5,5,0,11,31,65
Mississippi Valley State13,13,Henry Taylor,FR,G,Mississippi Valley State,SWAC,31,145,11,34,6,12,5,22,7,11,2,17,19,10,6,0,13,24,34
Mississippi Valley State14,14,Kaleb Allison,FR,C,Mississippi Valley State,SWAC,24,131,10,29,10,29,0,0,3,11,13,12,25,2,3,1,11,17,23
Mississippi Valley State15,15,Jamal Watson,SR,C,Mississippi Valley State,SWAC,8,124,11,22,11,22,0,0,3,6,5,19,24,9,2,4,6,17,25
Missouri1,1,Kassius Robertson,SR,G,Missouri,SEC,32,1149,152,361,53,128,99,233,115,144,9,86,95,77,32,2,73,55,518
Missouri2,2,Jordan Barnett,SR,F,Missouri,SEC,32,1091,142,316,60,118,82,198,73,82,50,139,189,35,23,19,50,51,439
Missouri3,3,Jordan Geist,JR,G,Missouri,SEC,32,825,72,161,40,75,32,86,62,87,19,106,125,92,27,0,55,59,238
Missouri4,4,Kevin Puryear,JR,F,Missouri,SEC,32,799,91,206,78,156,13,50,82,100,50,86,136,27,10,8,47,72,277
Missouri5,5,Jontay Porter,FR,F,Missouri,SEC,32,780,103,231,63,125,40,106,78,102,50,168,218,69,27,53,61,93,324
Missouri6,6,Jeremiah Tilmon,FR,F,Missouri,SEC,32,627,114,201,114,201,0,0,38,74,62,74,136,15,8,32,69,116,266
Missouri7,7,Cullen VanLeer,JR,G,Missouri,SEC,31,442,27,74,8,10,19,64,0,7,2,41,43,30,13,0,21,28,73
Missouri8,8,Reed Nikko,SO,F,Missouri,SEC,32,258,28,51,28,51,0,0,21,40,21,44,65,6,4,21,16,36,77
Missouri9,9,Terrence Phillips,JR,G,Missouri,SEC,20,212,15,33,8,13,7,20,13,16,7,22,29,37,5,0,22,39,50
Missouri10,10,Blake Harris,FR,G,Missouri,SEC,14,195,22,54,22,47,0,7,9,13,6,28,34,44,14,0,24,20,53
Missouri11,11,Brett Rau,SR,G,Missouri,SEC,10,37,3,6,2,4,1,2,0,2,1,1,2,2,1,0,2,2,7
Missouri12,12,Michael Porter Jr.,FR,F,Missouri,SEC,2,25,6,18,4,12,2,6,0,0,3,7,10,1,0,1,0,2,14
Missouri13,13,Adam Wolf,JR,F,Missouri,SEC,4,10,3,4,0,1,3,3,0,0,0,0,0,0,1,0,0,0,9
Missouri State1,1,Alize Johnson,SR,F,Missouri State,MVC,33,1028,172,400,131,254,41,146,110,145,104,280,384,94,15,14,74,69,495
Missouri State2,2,Jarrid Rhodes,SR,F,Missouri State,MVC,33,1009,122,284,57,119,65,165,43,48,40,95,135,47,19,6,33,61,352
Missouri State3,3,Jarred Dixon,JR,G,Missouri State,MVC,33,951,113,266,80,184,33,82,42,56,22,69,91,72,23,11,44,62,301
Missouri State4,4,Obediah Church,JR,F,Missouri State,MVC,32,762,89,135,89,134,0,1,37,66,75,104,179,40,17,60,45,72,215
Missouri State5,5,J.T. Miller,SR,G,Missouri State,MVC,32,658,107,225,96,188,11,37,32,49,23,87,110,40,16,7,52,60,257
Missouri State6,6,Ryan Kreklow,JR,G,Missouri State,MVC,33,656,50,161,16,46,34,115,38,42,9,57,66,50,24,6,30,64,172
Missouri State7,7,Ronnie Rousseau III,SR,G,Missouri State,MVC,27,582,51,146,30,76,21,70,16,30,6,30,36,42,10,1,32,47,139
Missouri State8,8,Reggie Scurry,JR,F,Missouri State,MVC,21,359,74,147,72,138,2,9,36,54,37,51,88,3,5,19,21,52,186
Missouri State9,9,Mustafa Lawrence,FR,G,Missouri State,MVC,22,273,33,88,9,26,24,62,13,17,5,19,24,20,13,0,13,31,103
Missouri State10,10,Tanveer Bhullar,SR,C,Missouri State,MVC,24,201,30,70,30,69,0,1,7,15,22,31,53,14,5,8,20,37,67
Missouri State11,11,Ross Owens,SO,G,Missouri State,MVC,13,78,6,22,3,3,3,19,0,0,1,6,7,2,2,1,7,7,15
Missouri State12,12,Abdul Fofana,SO,F,Missouri State,MVC,13,68,4,8,4,8,0,0,3,5,4,12,16,1,4,1,6,13,11
Missouri-Kansas City1,1,Broderick Robinson,SR,G,Missouri-Kansas City,WAC,31,979,113,289,50,113,63,176,55,79,32,129,161,58,44,4,48,63,344
Missouri-Kansas City2,2,Xavier Bishop,SO,G,Missouri-Kansas City,WAC,32,952,122,317,77,182,45,135,81,108,16,76,92,105,23,1,61,86,370
Missouri-Kansas City3,3,Isaiah Ross,SO,G,Missouri-Kansas City,WAC,32,805,120,300,50,105,70,195,53,68,21,77,98,32,17,0,47,65,363
Missouri-Kansas City4,4,Aleer Leek,JR,F,Missouri-Kansas City,WAC,32,717,53,154,41,102,12,52,37,49,30,97,127,5,11,31,48,97,155
Missouri-Kansas City5,5,Brandon McKissic,FR,G,Missouri-Kansas City,WAC,31,713,86,187,61,127,25,60,47,75,18,68,86,48,24,3,40,94,244
Missouri-Kansas City6,6,Jordan Giles,SO,F,Missouri-Kansas City,WAC,30,664,92,211,75,141,17,70,106,142,32,68,100,30,18,10,77,104,307
Missouri-Kansas City7,7,Marco Smith,FR,G,Missouri-Kansas City,WAC,31,516,59,130,47,91,12,39,24,35,14,57,71,29,29,13,29,49,154
Missouri-Kansas City8,8,Tony Jackson,FR,F,Missouri-Kansas City,WAC,20,265,24,64,8,16,16,48,7,12,9,24,33,8,10,6,10,36,71
Missouri-Kansas City9,9,Robert Knar,SR,G,Missouri-Kansas City,WAC,27,254,24,51,18,36,6,15,14,17,2,32,34,21,6,0,8,5,68
Missouri-Kansas City10,10,Marvin Nesbitt Jr.,FR,G,Missouri-Kansas City,WAC,19,229,29,64,21,45,8,19,10,14,15,44,59,15,12,5,11,36,76
Missouri-Kansas City11,11,Steve Dulley,FR,G,Missouri-Kansas City,WAC,25,196,21,64,11,28,10,36,14,27,12,19,31,3,4,2,10,26,66
Missouri-Kansas City12,12,Mo Ahmed,JR,C,Missouri-Kansas City,WAC,18,135,13,28,13,28,0,0,7,14,8,19,27,0,4,6,8,20,33
Monmouth1,1,Austin Tilghman,SR,G,Monmouth,MAAC,30,1002,107,231,99,193,8,38,110,151,19,158,177,165,43,2,88,55,332
Monmouth2,2,Deion Hammond,FR,G,Monmouth,MAAC,31,783,123,299,47,105,76,194,49,73,17,57,74,27,24,6,39,68,371
Monmouth3,3,Ray Salnave,FR,G,Monmouth,MAAC,30,659,82,200,62,138,20,62,109,145,17,87,104,49,39,4,71,87,293
Monmouth4,4,Melik Martin,FR,F,Monmouth,MAAC,31,552,44,104,33,70,11,34,21,33,24,67,91,27,14,12,31,61,120
Monmouth5,5,Diago Quinn,JR,F,Monmouth,MAAC,31,552,77,151,77,151,0,0,57,90,48,84,132,5,6,19,35,93,211
Monmouth6,6,Zac Tillman,FR,C,Monmouth,MAAC,31,517,79,139,79,139,0,0,51,70,32,62,94,22,14,10,42,73,209
Monmouth7,7,Louie Pillari,SO,G,Monmouth,MAAC,31,507,79,169,35,70,44,99,28,31,7,30,37,16,7,2,25,44,230
Monmouth8,8,Micah Seaborn,JR,G,Monmouth,MAAC,18,465,79,181,37,86,42,95,47,53,4,64,68,34,15,3,48,32,247
Monmouth9,9,Mustapha Traore,SO,F,Monmouth,MAAC,29,417,35,75,35,74,0,1,16,32,31,77,108,19,7,6,22,47,86
Monmouth10,10,Marcus McClary,FR,G,Monmouth,MAAC,31,405,30,59,28,56,2,3,13,24,14,36,50,10,8,0,14,44,75
Monmouth11,11,Pierre Sarr,JR,F,Monmouth,MAAC,23,224,21,41,15,29,6,12,24,34,15,50,65,12,9,6,23,36,72
Monmouth12,12,George Papas,FR,G,Monmouth,MAAC,18,177,16,43,3,9,13,34,9,11,1,15,16,10,7,0,12,11,54
Monmouth13,13,Sam Ibiezugbe,SO,F,Monmouth,MAAC,20,123,14,24,14,24,0,0,0,5,6,13,19,1,4,3,7,22,28
Monmouth14,14,Daniel Pillari,SR,G,Monmouth,MAAC,8,17,1,2,0,0,1,2,5,6,0,1,1,2,0,0,2,2,8
Montana1,1,Ahmaad Rorie,JR,G,Montana,Big Sky,33,1179,200,471,143,304,57,167,112,132,31,95,126,123,40,5,66,63,569
Montana2,2,Michael Oguine,JR,G,Montana,Big Sky,33,1063,172,373,127,247,45,126,133,182,72,109,181,64,48,18,42,91,522
Montana3,3,Bobby Moorehead,JR,G,Montana,Big Sky,33,1046,81,210,30,68,51,142,34,47,26,139,165,41,40,17,38,71,247
Montana4,4,Jamar Akoh,JR,F,Montana,Big Sky,33,859,157,271,156,266,1,5,118,177,77,143,220,36,29,22,69,111,433
Montana5,5,Fabijan Krslovic,SR,F,Montana,Big Sky,33,813,90,158,90,152,0,6,66,92,51,118,169,48,30,19,49,93,246
Montana6,6,Sayeed Pridgett,SO,G,Montana,Big Sky,33,752,119,253,116,238,3,15,39,59,34,110,144,44,38,14,63,99,280
Montana7,7,Timmy Falls,FR,G,Montana,Big Sky,32,548,48,115,26,62,22,53,26,36,7,25,32,50,24,2,38,73,144
Montana8,8,Karl Nicholas,FR,F,Montana,Big Sky,30,287,47,78,47,78,0,0,12,36,31,37,68,5,6,12,29,70,106
Montana9,9,Trevor Spoja,SO,G,Montana,Big Sky,18,56,3,17,1,3,2,14,1,2,1,2,3,3,0,1,3,8,9
Montana10,10,Lars Espe,FR,G,Montana,Big Sky,17,42,2,6,1,3,1,3,1,5,2,1,3,5,0,1,2,4,6
Montana11,11,Admir Besovic,FR,C,Montana,Big Sky,18,31,6,9,6,9,0,0,1,1,2,3,5,1,0,1,2,10,13
Montana12,12,Niko Bevens,SO,G,Montana,Big Sky,15,24,1,4,0,1,1,3,0,0,1,0,1,1,1,0,1,2,3
Montana State1,1,Harald Frey,SO,G,Montana State,Big Sky,32,1033,133,311,69,140,64,171,88,115,11,89,100,103,26,1,55,54,418
Montana State2,2,Tyler Hall,JR,G,Montana State,Big Sky,31,994,174,428,75,162,99,266,97,107,23,93,116,86,25,12,56,53,544
Montana State3,3,Keljin Blevins,JR,F,Montana State,Big Sky,32,781,108,255,99,217,9,38,86,126,66,120,186,30,19,13,68,71,311
Montana State4,4,Devonte Klines,JR,G,Montana State,Big Sky,32,753,87,223,76,177,11,46,49,82,22,34,56,45,18,6,54,77,234
Montana State5,5,Joe Mvuezolo Jr.,SR,F,Montana State,Big Sky,32,667,89,220,60,134,29,86,43,62,21,88,109,25,18,19,38,53,250
Montana State6,6,Sam Neumann,JR,F,Montana State,Big Sky,32,622,40,74,30,46,10,28,40,55,45,97,142,27,12,1,21,86,130
Montana State7,7,Konner Frey,SR,F,Montana State,Big Sky,32,546,82,156,63,112,19,44,47,64,54,107,161,22,21,2,23,100,230
Montana State8,8,Zach Green,SR,G,Montana State,Big Sky,32,527,51,126,46,104,5,22,47,69,45,87,132,32,15,8,35,67,154
Montana State9,9,Isaac Bonton,FR,G,Montana State,Big Sky,11,207,31,86,23,64,8,22,16,21,4,27,31,15,9,2,25,30,86
Montana State10,10,Lassi Nikkarinen,FR,G,Montana State,Big Sky,23,169,4,13,1,5,3,8,4,5,1,12,13,13,6,0,7,21,15
Montana State11,11,Benson Osayande,SR,F,Montana State,Big Sky,21,127,13,29,13,29,0,0,19,26,18,8,26,3,5,2,9,22,45
Montana State12,12,Luke Schultz,FR,C,Montana State,Big Sky,10,49,5,8,5,8,0,0,7,14,9,7,16,0,2,0,5,11,17
Morehead State1,1,Jordan Walker,SO,G,Morehead State,OVC,29,916,111,289,68,159,43,130,88,119,19,73,92,77,35,8,75,84,353
Morehead State2,2,Adrian Hicks,JR,G,Morehead State,OVC,29,885,98,231,73,151,25,80,99,155,24,63,87,122,51,8,84,62,320
Morehead State3,3,Djimon Henson,SO,G,Morehead State,OVC,29,790,101,255,49,116,52,139,36,49,20,62,82,22,9,4,43,55,290
Morehead State4,4,Malek Green,FR,F,Morehead State,OVC,28,658,74,152,70,139,4,13,33,54,46,101,147,10,10,17,29,67,185
Morehead State5,5,Lamontray Harris,JR,F,Morehead State,OVC,26,603,106,225,89,157,17,68,58,67,57,108,165,24,13,9,55,81,287
Morehead State6,6,De'Von Cooper,,G,Morehead State,OVC,29,592,58,168,29,76,29,92,29,35,14,63,77,39,12,5,34,38,174
Morehead State7,7,Londell King,,F,Morehead State,OVC,26,517,83,154,71,115,12,39,43,62,69,104,173,18,15,27,52,77,221
Morehead State8,8,Alonzo Chatman,SO,F,Morehead State,OVC,24,289,23,38,23,38,0,0,12,25,23,33,56,8,3,0,29,62,58
Morehead State9,9,James Baker,FR,F,Morehead State,OVC,24,225,23,51,14,24,9,27,12,16,16,22,38,6,7,7,15,38,67
Morehead State10,10,Trell Thompson,JR,G,Morehead State,OVC,14,164,19,53,11,23,8,30,3,5,10,17,27,6,6,1,11,13,49
Morehead State11,11,Richard Feagin,FR,G,Morehead State,OVC,19,133,9,23,5,14,4,9,0,0,3,19,22,12,3,0,11,8,22
Morehead State12,12,Cedric Wright,SO,F,Morehead State,OVC,4,36,6,9,6,9,0,0,1,3,4,4,8,0,1,0,4,13,13
Morehead State13,13,Austin Crawford,FR,G,Morehead State,OVC,9,17,1,7,0,3,1,4,1,2,0,1,1,0,0,0,1,0,4
Morgan State1,1,Martez Cameron,,G,Morgan State,MEAC,32,1031,101,272,91,244,10,28,60,87,27,62,89,138,46,2,92,60,272
Morgan State2,2,Phillip Carr,SR,F,Morgan State,MEAC,31,1018,152,352,141,311,11,41,110,130,91,197,288,39,21,21,53,77,425
Morgan State3,3,Tiwian Kendley,,G,Morgan State,MEAC,22,717,176,395,143,272,33,123,181,238,27,60,87,48,45,7,79,61,566
Morgan State4,4,Stanley Davis,SO,G,Morgan State,MEAC,32,684,89,210,80,170,9,40,47,65,27,65,92,53,24,4,59,65,234
Morgan State5,5,David Syfax,SO,F,Morgan State,MEAC,29,571,69,176,57,138,12,38,38,63,42,84,126,19,16,20,34,86,188
Morgan State6,6,Lapri McCray-Pace,FR,G,Morgan State,MEAC,28,466,50,133,35,96,15,37,45,65,34,40,74,22,22,8,24,57,160
Morgan State7,7,Antonio Gillespie,JR,G,Morgan State,MEAC,32,445,40,106,9,21,31,85,8,10,11,27,38,14,11,1,15,56,119
Morgan State8,8,Azariah Sykes,SO,C,Morgan State,MEAC,28,412,9,16,9,15,0,1,15,29,32,76,108,8,10,9,12,73,33
Morgan State9,9,Alex Ennis,JR,F,Morgan State,MEAC,26,256,12,32,12,32,0,0,10,15,20,36,56,3,4,2,10,33,34
Morgan State10,10,Kyson Rawls,FR,G,Morgan State,MEAC,20,250,32,79,6,21,26,58,14,19,5,11,16,22,12,1,18,19,104
Morgan State11,11,Elijah Staley,JR,F,Morgan State,MEAC,22,208,16,34,16,34,0,0,8,15,24,23,47,12,3,2,15,24,40
Morgan State12,12,Khalil Gracey,JR,G,Morgan State,MEAC,23,179,24,60,17,39,7,21,9,16,8,15,23,13,8,1,13,19,64
Morgan State13,13,Tyler Streeter,JR,G,Morgan State,MEAC,19,106,25,47,16,27,9,20,5,7,9,7,16,4,3,0,11,7,64
Morgan State14,14,Tyjhai Byers,SO,C,Morgan State,MEAC,9,90,4,9,4,9,0,0,0,2,11,14,25,0,1,11,2,12,8
Mount St. Mary's1,1,Junior Robinson,SR,G,Mount St. Mary's,NEC,32,1162,228,511,150,310,78,201,169,188,19,73,92,154,37,1,89,87,703
Mount St. Mary's2,2,Jonah Antonio,FR,G,Mount St. Mary's,NEC,32,1071,122,333,32,67,90,266,29,36,14,107,121,21,41,18,19,42,363
Mount St. Mary's3,3,Donald Carey,FR,G,Mount St. Mary's,NEC,32,1006,98,240,59,133,39,107,54,66,11,74,85,110,32,3,86,60,289
Mount St. Mary's4,4,Greg Alexander,SR,G,Mount St. Mary's,NEC,32,889,115,246,42,64,73,182,31,40,7,77,84,26,22,11,22,54,334
Mount St. Mary's5,5,Chris Wray,,F,Mount St. Mary's,NEC,24,768,102,164,102,163,0,1,27,84,72,126,198,89,49,50,46,61,231
Mount St. Mary's6,6,Bobby Planutis,FR,F,Mount St. Mary's,NEC,32,759,55,116,22,49,33,67,36,40,24,102,126,22,15,20,40,79,179
Mount St. Mary's7,7,Omar Habwe,FR,F,Mount St. Mary's,NEC,31,345,27,48,20,29,7,19,21,31,14,34,48,8,11,3,8,33,82
Mount St. Mary's8,8,Ryan Gomes,SO,C,Mount St. Mary's,NEC,32,343,54,94,54,94,0,0,15,32,18,39,57,8,9,16,19,53,123
Mount St. Mary's9,9,James West IV,FR,G,Mount St. Mary's,NEC,9,48,3,9,0,2,3,7,2,2,1,3,4,3,2,1,4,5,11
Mount St. Mary's10,10,Ace Stallings,FR,F,Mount St. Mary's,NEC,8,43,2,5,2,5,0,0,2,5,3,6,9,2,1,2,1,9,6
Mount St. Mary's11,11,Ross Young,FR,F,Mount St. Mary's,NEC,5,13,2,3,2,3,0,0,2,4,3,0,3,0,0,0,1,6,6
Mount St. Mary's12,12,Brandon Leftwich,FR,G,Mount St. Mary's,NEC,10,12,1,4,1,4,0,0,2,4,0,2,2,4,2,0,3,1,4
Mount St. Mary's13,13,Jack Vukelich,FR,F,Mount St. Mary's,NEC,5,10,0,4,0,2,0,2,0,0,2,0,2,0,0,0,0,2,0
Mount St. Mary's14,14,Damon'te Moore,,G,Mount St. Mary's,NEC,2,4,0,0,0,0,0,0,0,0,0,0,0,0,0,0,0,0,0
Mount St. Mary's15,15,Odri Dedolli,,G,Mount St. Mary's,NEC,1,2,0,1,0,0,0,1,0,0,0,1,1,0,0,0,0,0,0
Murray State1,1,Jonathan Stark,SR,G,Murray State,OVC,31,1126,220,478,111,212,109,266,127,143,12,73,85,122,42,6,76,53,676
Murray State2,2,Temetrius Morant,FR,G,Murray State,OVC,31,1052,128,280,101,194,27,86,108,134,53,152,205,199,29,10,76,60,391
Murray State3,3,Terrell Miller Jr.,SR,F,Murray State,OVC,31,943,170,344,105,178,65,166,51,72,30,228,258,49,24,15,54,76,456
Murray State4,4,Leroy Buchanan,JR,G,Murray State,OVC,31,847,114,222,94,158,20,64,38,54,33,91,124,33,50,12,41,66,286
Murray State5,5,Byron Hawkins,JR,G,Murray State,OVC,29,549,67,152,33,66,34,86,39,56,15,22,37,29,19,0,24,44,207
Murray State6,6,Brion Sanchious,JR,F,Murray State,OVC,31,541,43,70,43,70,0,0,7,25,32,56,88,8,18,12,21,62,93
Murray State7,7,Jalen Dupree,SO,F,Murray State,OVC,29,508,56,99,56,99,0,0,56,84,57,71,128,4,7,23,23,66,168
Murray State8,8,Anthony Smith,JR,F,Murray State,OVC,31,447,31,58,30,56,1,2,51,74,45,60,105,9,19,18,37,88,114
Murray State9,9,Jachai Taylor,SO,G,Murray State,OVC,15,86,6,19,3,8,3,11,0,2,1,9,10,0,1,1,2,11,15
Murray State10,10,Brion Whitley,FR,G,Murray State,OVC,14,46,7,14,4,4,3,10,5,9,2,4,6,2,1,0,3,4,22
Murray State11,11,Devin Gilmore,FR,F,Murray State,OVC,12,29,4,7,4,7,0,0,0,2,2,10,12,0,1,1,1,3,8
Murray State12,12,Zach Hopewell,FR,G,Murray State,OVC,12,26,3,9,1,4,2,5,3,9,1,1,2,4,0,0,2,4,11
Navy1,1,Shawn Anderson,SR,G,Navy,Patriot,31,952,141,314,121,252,20,62,110,148,44,114,158,104,31,1,89,59,412
Navy2,2,Bryce Dulin,SR,G,Navy,Patriot,32,927,113,282,74,153,39,129,58,91,27,73,100,55,22,5,52,64,323
Navy3,3,Hasan Abdullah,JR,G,Navy,Patriot,30,874,106,263,57,126,49,137,37,59,8,83,91,101,65,1,88,82,298
Navy4,4,Tom Lacey,SR,F,Navy,Patriot,31,810,89,175,88,169,1,6,88,131,62,141,203,51,24,11,54,73,267
Navy5,5,Evan Wieck,SO,C,Navy,Patriot,32,625,79,123,79,123,0,0,19,27,48,54,102,21,13,9,23,76,177
Navy6,6,George Kiernan,JR,F,Navy,Patriot,30,600,93,231,46,92,47,139,61,74,29,111,140,23,10,5,40,73,294
Navy7,7,Cam Davis,FR,G,Navy,Patriot,32,549,58,125,32,60,26,65,24,30,3,29,32,22,9,1,22,25,166
Navy8,8,Tyler Riemersma,FR,F,Navy,Patriot,28,288,20,51,20,46,0,5,19,25,34,43,77,22,11,6,19,20,59
Navy9,9,Nourse Fox,SR,G,Navy,Patriot,30,280,9,33,8,18,1,15,8,10,3,18,21,29,12,0,21,28,27
Navy10,10,Ryan Pearson,JR,G,Navy,Patriot,30,215,28,71,10,24,18,47,8,10,2,13,15,8,3,0,8,16,82
Navy11,11,Mo Lewis,JR,F,Navy,Patriot,21,188,18,31,18,31,0,0,14,15,25,19,44,6,5,1,7,29,50
Navy12,12,Dom Antonelli,JR,G,Navy,Patriot,8,31,2,9,1,3,1,6,0,0,0,6,6,0,0,0,1,0,5
Navy13,13,Matt Cullen,SO,G,Navy,Patriot,6,21,3,5,1,1,2,4,0,0,0,0,0,4,1,0,1,2,8
Navy14,14,JR Mathis,FR,G,Navy,Patriot,5,14,2,4,1,2,1,2,0,0,0,0,0,1,0,0,1,0,5
Navy15,15,Danny Ogele,FR,F,Navy,Patriot,3,12,1,2,1,2,0,0,0,0,2,2,4,3,0,0,0,0,2
Navy16,16,Connor Mannion,SO,F,Navy,Patriot,3,12,1,3,1,1,0,2,2,2,2,3,5,0,0,0,0,1,4
Navy17,17,Luke Loehr,FR,F,Navy,Patriot,3,10,5,7,5,6,0,1,0,0,1,2,3,0,0,0,3,5,10
Navy18,18,Ryan Reagan,FR,F,Navy,Patriot,2,7,2,4,2,4,0,0,2,3,1,1,2,0,0,0,0,0,6
Navy19,19,Alex Loehr,FR,F,Navy,Patriot,2,4,1,1,0,0,1,1,1,2,1,1,2,0,0,0,0,0,4
Navy20,20,Eli Lake,FR,G,Navy,Patriot,1,3,0,0,0,0,0,0,0,0,0,1,1,0,0,0,1,0,0
Navy21,21,Jack Lawrence,FR,C,Navy,Patriot,1,3,0,2,0,2,0,0,0,0,0,0,0,0,0,1,0,0,0
Nebraska1,1,James Palmer,JR,G,Nebraska,Big Ten,32,989,176,393,133,259,43,134,160,217,38,100,138,94,31,14,71,58,555
Nebraska2,2,Isaac Copeland,JR,F,Nebraska,Big Ten,32,981,154,324,115,217,39,107,64,92,53,146,199,38,27,33,32,51,411
Nebraska3,3,Glynn Watson Jr.,JR,G,Nebraska,Big Ten,32,950,117,334,84,219,33,115,70,89,24,83,107,104,44,7,48,74,337
Nebraska4,4,Evan Taylor,SR,G,Nebraska,Big Ten,32,830,67,156,52,123,15,33,58,81,26,86,112,73,32,15,40,65,207
Nebraska5,5,Isaiah Roby,SO,F,Nebraska,Big Ten,31,745,92,161,76,122,16,39,70,97,52,140,192,53,20,62,46,98,270
Nebraska6,6,Anton Gill,SR,G,Nebraska,Big Ten,30,729,78,195,25,57,53,138,34,41,5,51,56,33,13,2,22,44,243
Nebraska7,7,Jordy Tshimanga,SO,C,Nebraska,Big Ten,30,410,49,106,49,106,0,0,22,39,58,82,140,15,7,13,37,71,120
Nebraska8,8,Thomas Allen,FR,G,Nebraska,Big Ten,31,310,34,86,17,38,17,48,16,20,5,26,31,16,7,0,20,8,101
Nebraska9,9,Duby Okeke,SR,C,Nebraska,Big Ten,27,192,8,19,8,19,0,0,4,10,24,25,49,2,5,27,17,39,20
Nebraska10,10,Tanner Borchardt,JR,F,Nebraska,Big Ten,20,118,6,13,6,13,0,0,6,14,17,19,36,2,2,4,2,23,18
Nebraska11,11,Jack McVeigh,JR,F,Nebraska,Big Ten,14,105,10,29,4,11,6,18,1,1,4,11,15,2,5,2,5,11,27
Nebraska12,12,Nana Akenten,FR,G,Nebraska,Big Ten,7,21,2,9,0,1,2,8,1,2,1,1,2,0,0,0,0,0,7
Nebraska13,13,Thorir Thorbjarnarson,FR,G,Nebraska,Big Ten,9,19,3,7,1,2,2,5,0,0,1,3,4,3,1,0,1,4,8
Nebraska14,14,Malcolm Laws,SR,G,Nebraska,Big Ten,10,15,1,7,1,4,0,3,0,0,0,0,0,0,0,0,1,0,2
Nebraska15,15,Johnny Trueblood,SO,G,Nebraska,Big Ten,7,11,0,2,0,2,0,0,1,4,0,3,3,1,0,0,3,1,1
Nebraska-Omaha1,1,Zach Jackson,JR,G,Nebraska-Omaha,Summit,31,985,192,366,150,268,42,98,121,147,46,150,196,29,35,12,68,70,547
Nebraska-Omaha2,2,Daniel Norl,SR,G,Nebraska-Omaha,Summit,31,985,138,291,94,167,44,124,78,95,18,88,106,78,24,6,68,69,398
Nebraska-Omaha3,3,JT Gibson,SO,G,Nebraska-Omaha,Summit,31,878,113,258,56,110,57,148,33,38,9,63,72,81,27,4,52,63,316
Nebraska-Omaha4,4,KJ Robinson,SO,G,Nebraska-Omaha,Summit,28,815,100,262,59,148,41,114,28,34,5,57,62,74,23,3,68,39,269
Nebraska-Omaha5,5,Matt Pile,FR,F,Nebraska-Omaha,Summit,31,529,83,128,83,128,0,0,21,60,48,83,131,24,8,32,33,69,187
Nebraska-Omaha6,6,Lamar Wofford-Humphrey,SR,F,Nebraska-Omaha,Summit,25,487,86,171,75,145,11,26,21,35,48,73,121,17,7,14,34,64,204
Nebraska-Omaha7,7,Ayo Akinwole,FR,G,Nebraska-Omaha,Summit,31,481,39,90,24,50,15,40,11,19,10,45,55,44,23,1,18,25,104
Nebraska-Omaha8,8,Mitchell Hahn,JR,F,Nebraska-Omaha,Summit,15,453,56,166,33,85,23,81,41,55,13,93,106,27,15,6,18,29,176
Nebraska-Omaha9,9,Daniel Meyer,SR,F,Nebraska-Omaha,Summit,27,276,33,78,33,77,0,1,6,27,26,33,59,12,3,4,18,37,72
Nebraska-Omaha10,10,Alex Allbery,SR,G,Nebraska-Omaha,Summit,26,217,19,41,13,27,6,14,3,5,10,14,24,8,11,1,14,19,47
Nebraska-Omaha11,11,Renard Suggs,,G,Nebraska-Omaha,Summit,18,188,18,61,3,13,15,48,2,2,2,17,19,11,1,0,10,14,53
Nebraska-Omaha12,12,Brenden Lipovsky,,G,Nebraska-Omaha,Summit,1,6,0,0,0,0,0,0,0,0,0,0,0,0,0,0,0,0,0
Nevada1,1,Jordan Caroline,JR,G,Nevada,MWC,34,1170,206,434,173,332,33,102,165,229,90,208,298,71,22,5,67,78,610
Nevada2,2,Cody Martin,JR,F,Nevada,MWC,33,1162,172,334,158,287,14,47,92,135,61,148,209,151,55,48,66,79,450
Nevada3,3,Caleb Martin,JR,F,Nevada,MWC,33,1091,204,444,115,226,89,218,132,176,31,143,174,85,41,18,56,86,629
Nevada4,4,Kendall Stephens,SR,G,Nevada,MWC,34,917,143,320,25,54,118,266,44,48,15,54,69,21,17,23,28,83,448
Nevada5,5,Lindsey Drew,JR,G,Nevada,MWC,27,789,77,159,61,118,16,41,50,62,25,86,111,117,26,24,35,72,220
Nevada6,6,Josh Hall,SO,G,Nevada,MWC,32,725,75,157,60,108,15,49,38,51,39,83,122,48,18,12,39,53,203
Nevada7,7,Hallice Cooke,SR,G,Nevada,MWC,34,679,54,122,12,36,42,86,18,21,8,63,71,54,20,4,21,72,168
Nevada8,8,Elijah Foster,SR,F,Nevada,MWC,30,207,17,42,17,40,0,2,19,26,10,38,48,10,8,3,7,33,53
Nevada9,9,Darien Williams,SR,F,Nevada,MWC,15,98,11,27,10,20,1,7,9,12,4,22,26,2,3,2,10,17,32
Nevada10,10,Charlie Tooley,SO,G,Nevada,MWC,11,15,2,12,0,1,2,11,2,2,2,0,2,0,1,0,4,7,8
Nevada11,11,John Jones,FR,G,Nevada,MWC,6,6,0,2,0,2,0,0,0,0,1,0,1,0,0,0,0,1,0
Nevada12,12,Justin Brent,,G,Nevada,MWC,3,5,1,1,1,1,0,0,0,0,0,0,0,0,1,0,0,2,2
Nevada13,13,Elijah Cooks,,G,Nevada,MWC,4,4,0,0,0,0,0,0,0,0,0,0,0,0,0,0,0,2,0
Nevada14,14,David Cunningham,,G,Nevada,MWC,4,4,1,2,1,1,0,1,0,0,0,0,0,0,1,0,0,1,2
Nevada-Las Vegas1,1,Jordan Johnson,SR,G,Nevada-Las Vegas,MWC,33,1132,124,290,75,164,49,126,153,182,15,78,93,199,39,8,90,76,450
Nevada-Las Vegas2,2,Jovan Mooring,SR,G,Nevada-Las Vegas,MWC,33,1077,135,362,72,160,63,202,122,152,9,91,100,110,38,2,62,75,455
Nevada-Las Vegas3,3,Shakur Juiston,JR,F,Nevada-Las Vegas,MWC,33,1002,218,341,216,339,2,2,44,86,89,240,329,64,30,21,84,93,482
Nevada-Las Vegas4,4,Brandon McCoy,FR,F,Nevada-Las Vegas,MWC,33,949,208,382,205,373,3,9,140,193,103,238,341,17,15,60,87,87,559
Nevada-Las Vegas5,5,Kris Clyburn,JR,G,Nevada-Las Vegas,MWC,33,748,84,205,50,101,34,104,39,69,40,65,105,48,17,9,43,43,241
Nevada-Las Vegas6,6,Amauri Hardy,FR,G,Nevada-Las Vegas,MWC,33,625,60,148,40,80,20,68,24,33,7,44,51,54,14,6,25,43,164
Nevada-Las Vegas7,7,Tervell Beck,FR,F,Nevada-Las Vegas,MWC,33,533,88,148,79,123,9,25,57,92,35,43,78,16,6,4,32,49,242
Nevada-Las Vegas8,8,Cheickna MBacke Diong,FR,F,Nevada-Las Vegas,MWC,29,276,22,40,22,40,0,0,18,29,20,54,74,6,13,21,21,59,62
Nevada-Las Vegas9,9,Cheickna Dembele,SO,F,Nevada-Las Vegas,MWC,25,177,14,30,14,30,0,0,13,28,23,9,32,10,5,14,12,19,41
Nevada-Las Vegas10,10,Anthony Smith,JR,F,Nevada-Las Vegas,MWC,13,144,20,40,16,27,4,13,1,2,14,14,28,8,6,1,8,24,45
Nevada-Las Vegas11,11,Jay Green,FR,G,Nevada-Las Vegas,MWC,15,62,5,14,4,9,1,5,1,2,3,1,4,3,1,0,5,12,12
New Hampshire1,1,Tanner Leissner,SR,F,New Hampshire,AEC,31,1111,195,432,157,317,38,115,153,199,81,133,214,63,15,10,50,65,581
New Hampshire2,2,Iba Camara,SR,F,New Hampshire,AEC,31,808,110,230,110,230,0,0,78,108,78,253,331,27,17,14,58,89,298
New Hampshire3,3,Jordan Reed,JR,G,New Hampshire,AEC,27,758,69,209,20,52,49,157,11,13,14,57,71,55,14,4,46,51,198
New Hampshire4,4,Josh Hopkins,FR,G,New Hampshire,AEC,31,722,74,225,22,55,52,170,31,40,21,48,69,19,7,7,24,57,231
New Hampshire5,5,John Ogwuche,SO,G,New Hampshire,AEC,30,671,59,146,29,65,30,81,30,38,21,66,87,29,14,6,25,52,178
New Hampshire6,6,Elijah Jordan,FR,G,New Hampshire,AEC,28,656,61,167,30,84,31,83,20,30,12,49,61,87,12,0,56,53,173
New Hampshire7,7,Jacoby Armstrong,SR,F,New Hampshire,AEC,29,583,69,146,60,111,9,35,40,55,45,74,119,35,8,8,33,92,187
New Hampshire8,8,Darryl Stewart,JR,G,New Hampshire,AEC,23,310,31,95,19,45,12,50,9,16,7,19,26,28,8,1,29,32,83
New Hampshire9,9,Keon Burns,SR,G,New Hampshire,AEC,22,217,21,50,2,10,19,40,3,4,5,26,31,8,3,1,11,17,64
New Hampshire10,10,Evan Horn,,G,New Hampshire,AEC,14,141,11,38,6,21,5,17,9,15,4,27,31,9,5,2,15,27,36
New Hampshire11,11,David Watkins,JR,F,New Hampshire,AEC,18,131,15,41,8,14,7,27,3,4,7,20,27,3,0,2,5,10,40
New Hampshire12,12,Luke Rosinski,SO,F,New Hampshire,AEC,12,64,3,13,3,12,0,1,11,17,9,9,18,3,5,0,6,5,17
New Hampshire13,13,Chris Lester,SO,F,New Hampshire,AEC,4,28,7,11,7,11,0,0,3,5,8,5,13,3,3,1,0,5,17
New Mexico1,1,Joe Furstinger,SR,F,New Mexico,MWC,33,895,117,211,113,187,4,24,105,131,49,175,224,70,22,53,49,97,343
New Mexico2,2,Chris McNeal,,G,New Mexico,MWC,34,829,102,274,46,96,56,178,63,83,6,56,62,93,26,0,64,56,323
New Mexico3,3,Antino Jackson,SR,G,New Mexico,MWC,33,775,112,275,43,97,69,178,51,67,11,57,68,151,47,0,80,80,344
New Mexico4,4,Anthony Mathis,JR,G,New Mexico,MWC,34,762,134,271,36,64,98,207,67,78,14,58,72,34,19,4,27,87,433
New Mexico5,5,Dane Kuiper,JR,F,New Mexico,MWC,34,755,69,192,29,63,40,129,41,49,15,95,110,51,32,7,26,73,219
New Mexico6,6,Troy Simmons,JR,G,New Mexico,MWC,29,676,96,242,43,96,53,146,41,52,33,56,89,42,52,5,32,67,286
New Mexico7,7,Makuach Maluach,FR,G,New Mexico,MWC,34,670,117,211,88,148,29,63,64,79,37,48,85,33,19,8,43,82,327
New Mexico8,8,Sam Logwood,SR,G,New Mexico,MWC,26,669,121,246,117,235,4,11,92,115,48,88,136,40,14,0,59,67,338
New Mexico9,9,Vladimir Pinchuk,FR,F,New Mexico,MWC,31,441,37,61,37,61,0,0,22,46,27,51,78,6,2,12,16,57,96
New Mexico10,10,Jachai Simmons,JR,F,New Mexico,MWC,25,341,33,81,19,38,14,43,4,8,14,27,41,18,18,7,14,29,84
New Mexico11,11,Mike Mondragon,,G,New Mexico,MWC,6,12,1,1,1,1,0,0,0,0,0,0,0,1,0,0,2,1,2
New Mexico State1,1,Zach Lofton,SR,G,New Mexico State,WAC,32,1017,207,457,124,240,83,217,134,175,37,127,164,55,34,4,66,66,631
New Mexico State2,2,Jemerrio Jones,SR,F,New Mexico State,WAC,33,925,162,321,158,279,4,42,36,67,124,311,435,102,35,18,79,73,364
New Mexico State3,3,A.J. Harris,SO,G,New Mexico State,WAC,32,884,119,294,82,168,37,126,32,58,14,49,63,94,29,10,53,67,307
New Mexico State4,4,Sidy N'Dir,,G,New Mexico State,WAC,33,874,86,205,54,107,32,98,60,80,31,69,100,47,21,16,44,66,264
New Mexico State5,5,Eli Chuha,JR,F,New Mexico State,WAC,32,599,105,205,97,173,8,32,54,91,61,97,158,29,14,7,44,67,272
New Mexico State6,6,Johnathon Wilkins,SR,F,New Mexico State,WAC,33,585,91,162,77,126,14,36,13,25,44,49,93,43,5,20,30,76,209
New Mexico State7,7,Johnny McCants,JR,F,New Mexico State,WAC,33,507,61,105,61,102,0,3,14,36,54,87,141,13,13,24,22,55,136
New Mexico State8,8,Shunn Buchanan,SO,G,New Mexico State,WAC,33,478,22,85,12,51,10,34,15,23,6,52,58,55,12,0,32,38,69
New Mexico State9,9,Keyon Jones,JR,G,New Mexico State,WAC,29,400,51,115,14,25,37,90,8,13,9,40,49,16,19,1,19,48,147
New Mexico State10,10,Joe Garza,SR,G,New Mexico State,WAC,18,151,8,30,0,2,8,28,6,7,0,8,8,4,1,0,8,16,30
New Mexico State11,11,Gabe Hadley,FR,G,New Mexico State,WAC,21,134,19,49,3,8,16,41,1,2,1,10,11,4,2,1,4,2,55
New Mexico State12,12,Leston Gordon,JR,C,New Mexico State,WAC,19,38,4,9,4,9,0,0,1,4,5,6,11,3,1,0,5,10,9
New Mexico State13,13,Kortrijk Miles,FR,G,New Mexico State,WAC,14,32,4,5,4,4,0,1,3,5,2,5,7,2,0,0,4,7,11
New Mexico State14,14,Wayne Stewart,JR,G,New Mexico State,WAC,1,1,0,0,0,0,0,0,0,0,0,0,0,0,0,0,0,0,0
New Orleans1,1,Makur Puou,SR,F,New Orleans,Southland,31,828,100,205,100,204,0,1,67,96,59,108,167,28,20,24,59,65,267
New Orleans2,2,Travin Thibodeaux,SR,F,New Orleans,Southland,26,746,160,294,144,254,16,40,87,126,29,119,148,76,36,29,56,69,423
New Orleans3,3,Bryson Robinson,SO,G,New Orleans,Southland,27,673,81,204,31,67,50,137,45,55,14,45,59,75,22,0,44,40,257
New Orleans4,4,Troy Green,FR,G,New Orleans,Southland,31,610,74,164,70,146,4,18,78,109,24,58,82,65,15,1,54,77,230
New Orleans5,5,Ezekiel Charles,JR,G,New Orleans,Southland,29,605,66,156,22,59,44,97,26,36,32,62,94,27,17,6,29,38,202
New Orleans6,6,Michael Zeno,SR,G,New Orleans,Southland,31,570,61,179,61,175,0,4,50,79,30,72,102,43,26,11,52,47,172
New Orleans7,7,Dionte Champion,JR,G,New Orleans,Southland,28,509,51,97,47,76,4,21,47,67,27,55,82,21,25,7,26,61,153
New Orleans8,8,Lamont Berzat,FR,G,New Orleans,Southland,29,449,35,84,18,35,17,49,23,35,4,28,32,44,30,0,30,42,110
New Orleans9,9,Damion Rosser,FR,G,New Orleans,Southland,31,444,52,108,50,101,2,7,27,52,27,41,68,26,7,3,32,49,133
New Orleans10,10,Scott Plaisance,,F,New Orleans,Southland,23,321,39,99,38,93,1,6,17,25,22,33,55,11,14,14,32,53,96
New Orleans11,11,Tyren Harrison,JR,G,New Orleans,Southland,24,223,18,32,15,24,3,8,6,13,13,27,40,20,7,7,21,22,45
New Orleans12,12,Matthew Jiles,SR,G,New Orleans,Southland,23,158,11,32,6,14,5,18,7,13,3,2,5,6,7,1,10,12,34
New Orleans13,13,Bol Riek,,C,New Orleans,Southland,11,41,4,8,3,6,1,2,5,9,4,5,9,3,0,6,4,8,14
New Orleans14,14,Jorge Rosa,SR,G,New Orleans,Southland,2,26,4,9,4,6,0,3,2,2,2,4,6,4,0,0,0,2,10
New Orleans15,15,Charles Bohannon,,G,New Orleans,Southland,11,22,2,7,2,3,0,4,1,2,0,2,2,1,0,0,4,1,5
Niagara1,1,Kahlil Dukes,SR,G,Niagara,MAAC,32,1083,218,465,124,244,94,221,146,160,6,64,70,104,24,1,76,55,676
Niagara2,2,Marvin Prochet,JR,F,Niagara,MAAC,32,1053,112,268,62,137,50,131,54,77,64,187,251,57,27,33,21,71,328
Niagara3,3,Matt Scott,SR,G,Niagara,MAAC,28,942,177,413,130,266,47,147,146,206,67,139,206,75,33,14,63,59,547
Niagara4,4,Dominic Robb,JR,F,Niagara,MAAC,32,618,88,152,87,150,1,2,44,74,42,87,129,13,6,46,28,76,221
Niagara5,5,James Towns,SO,G,Niagara,MAAC,32,586,92,187,68,122,24,65,89,113,9,45,54,68,18,0,53,33,297
Niagara6,6,Greg King,JR,F,Niagara,MAAC,32,537,65,110,65,110,0,0,18,50,65,113,178,10,9,23,28,81,148
Niagara7,7,Keleaf Tate,FR,G,Niagara,MAAC,31,471,53,150,27,81,26,69,11,21,18,37,55,12,16,0,17,39,143
Niagara8,8,Chris Barton,SO,G,Niagara,MAAC,26,423,37,94,32,77,5,17,46,57,14,29,43,22,6,0,31,47,125
Niagara9,9,Kevin Larkin,JR,G,Niagara,MAAC,28,366,43,125,26,68,17,57,11,15,15,58,73,12,13,3,16,39,114
Niagara10,10,Greg Kuakumensah,FR,F,Niagara,MAAC,29,267,23,59,22,48,1,11,7,12,21,31,52,9,6,11,12,47,54
Niagara11,11,Kierell Green,FR,F,Niagara,MAAC,20,97,10,24,6,8,4,16,4,6,9,18,27,4,3,8,7,22,28
Niagara12,12,Sam Volmy,,G,Niagara,MAAC,4,5,0,3,0,2,0,1,2,2,0,2,2,0,0,0,0,1,2
Niagara13,13,Dominik Fragala,,G,Niagara,MAAC,1,2,0,0,0,0,0,0,0,0,0,0,0,0,0,0,0,0,0
Nicholls State1,1,Kevin Johnson,FR,G,Nicholls State,Southland,32,962,78,199,52,112,26,87,28,38,26,63,89,84,61,0,37,68,210
Nicholls State2,2,Jahvaughn Powell,SR,G,Nicholls State,Southland,32,894,112,271,42,84,70,187,23,30,10,80,90,86,74,0,62,89,317
Nicholls State3,3,Tevon Saddler,SR,G,Nicholls State,Southland,30,878,162,343,143,272,19,71,131,171,45,154,199,85,48,7,95,89,474
Nicholls State4,4,Roddy Peters,SR,G,Nicholls State,Southland,32,858,229,445,218,407,11,38,160,210,28,160,188,135,44,6,121,79,629
Nicholls State5,5,Kimani Jackson,SR,F,Nicholls State,Southland,32,676,104,161,103,157,1,4,65,96,78,106,184,12,23,26,53,115,274
Nicholls State6,6,Lafayette Rutledge,SR,G,Nicholls State,Southland,32,668,99,247,2,7,97,240,28,37,7,37,44,14,20,0,12,42,323
Nicholls State7,7,Ryghe Lyons,FR,F,Nicholls State,Southland,28,507,63,111,62,107,1,4,13,25,45,57,102,38,18,44,49,69,140
Nicholls State8,8,Legend Robertin,SR,C,Nicholls State,Southland,32,301,30,55,30,54,0,1,14,26,25,43,68,1,1,38,23,67,74
Nicholls State9,9,Daniel Regis,JR,C,Nicholls State,Southland,19,216,16,34,16,33,0,1,18,34,22,29,51,4,2,4,14,43,50
Nicholls State10,10,Stevie Repichowski,SR,G,Nicholls State,Southland,23,191,23,56,3,7,20,49,3,4,3,12,15,2,6,0,4,21,69
Nicholls State11,11,Zaquavian Smith,JR,G,Nicholls State,Southland,6,133,18,52,6,16,12,36,8,11,4,18,22,3,5,0,5,16,56
Nicholls State12,12,Zach Young,SR,G,Nicholls State,Southland,15,53,1,10,1,5,0,5,6,8,0,5,5,8,4,0,5,5,8
Nicholls State13,13,Maurice O'Field,,G,Nicholls State,Southland,4,39,6,7,3,3,3,4,2,6,2,9,11,0,1,1,2,5,17
Nicholls State14,14,Rafe Blades,FR,G,Nicholls State,Southland,10,23,0,3,0,1,0,2,0,0,2,4,6,2,0,0,2,4,0
NJIT1,1,Anthony Tarke,SO,G,NJIT,A-Sun,30,930,161,399,120,256,41,143,91,142,45,136,181,57,38,24,60,65,454
NJIT2,2,Abdul Lewis,,F,NJIT,A-Sun,28,813,120,236,110,211,10,25,88,134,89,157,246,56,10,24,85,82,338
NJIT3,3,Diandre Wilson,JR,G,NJIT,A-Sun,29,732,101,243,60,139,41,104,52,76,10,55,65,39,33,12,53,61,295
NJIT4,4,Shyquan Gibbs,SO,G,NJIT,A-Sun,30,671,55,117,31,69,24,48,39,48,10,56,66,57,31,2,29,73,173
NJIT5,5,Zach Cooks,FR,G,NJIT,A-Sun,30,663,87,191,46,96,41,95,41,56,11,54,65,64,48,5,50,34,256
NJIT6,6,Reilly Walsh,JR,G,NJIT,A-Sun,30,586,52,110,37,65,15,45,11,19,26,55,81,34,31,1,26,62,130
NJIT7,7,Shawndale Jones,FR,G,NJIT,A-Sun,30,486,71,166,51,112,20,54,31,42,22,58,80,30,16,2,24,31,193
NJIT8,8,Mohamed Bendary,JR,F,NJIT,A-Sun,29,345,54,76,54,76,0,0,4,10,37,51,88,26,10,13,25,53,112
NJIT9,9,Donovan Greer,JR,G,NJIT,A-Sun,25,332,39,105,11,26,28,79,8,10,12,24,36,24,8,0,13,41,114
NJIT10,10,San Antonio Brinson,FR,F,NJIT,A-Sun,23,186,22,56,22,44,0,12,16,23,17,31,48,12,8,7,7,16,60
NJIT11,11,Chris Jenkins,SR,G,NJIT,A-Sun,13,111,11,38,0,4,11,34,0,0,1,6,7,5,3,0,4,8,33
NJIT12,12,David Kachelries,FR,G,NJIT,A-Sun,14,100,21,36,18,26,3,10,2,4,6,3,9,8,7,2,7,13,47
NJIT13,13,Taj Price,SO,F,NJIT,A-Sun,15,95,14,30,12,26,2,4,13,15,11,14,25,5,3,5,6,17,43
Norfolk State1,1,Steven Whitley,SO,G,Norfolk State,MEAC,33,946,144,323,113,234,31,89,85,130,44,145,189,154,53,4,101,92,404
Norfolk State2,2,Preston Bungei,SR,F,Norfolk State,MEAC,33,926,100,235,91,201,9,34,73,102,52,149,201,71,29,23,77,93,282
Norfolk State3,3,Kyle Williams,SR,G,Norfolk State,MEAC,32,871,101,242,36,79,65,163,40,58,23,91,114,44,22,8,51,53,307
Norfolk State4,4,Alex Long,JR,F,Norfolk State,MEAC,32,861,141,275,141,271,0,4,53,96,56,128,184,29,28,27,63,100,335
Norfolk State5,5,Derrik Jamerson Jr.,JR,G,Norfolk State,MEAC,33,842,102,240,27,52,75,188,3,5,44,59,103,14,30,10,27,68,282
Norfolk State6,6,Nic Thomas,SO,G,Norfolk State,MEAC,30,608,72,223,35,108,37,115,73,92,25,61,86,45,10,0,55,54,254
Norfolk State7,7,Mastadi Pitt,FR,G,Norfolk State,MEAC,29,590,81,213,49,124,32,89,51,69,7,48,55,67,12,0,41,55,245
Norfolk State8,8,Dan Robinson,SR,C,Norfolk State,MEAC,29,394,31,72,31,72,0,0,23,40,39,55,94,7,2,21,35,75,85
Norfolk State9,9,Bryan Gellineau,,C,Norfolk State,MEAC,26,293,48,80,48,80,0,0,12,21,29,27,56,9,6,9,27,61,108
Norfolk State10,10,Stavian Allen,SR,F,Norfolk State,MEAC,28,291,38,89,33,64,5,25,16,24,28,48,76,9,13,12,19,42,97
Norfolk State11,11,Vilontae Eanes,,G,Norfolk State,MEAC,2,3,0,0,0,0,0,0,0,2,0,0,0,1,1,0,0,0,0
North Carolina1,1,Luke Maye,JR,F,North Carolina,ACC,35,1141,243,491,195,382,48,109,68,110,106,247,353,83,35,38,65,84,602
North Carolina2,2,Joel Berry,SR,G,North Carolina,ACC,34,1121,195,493,106,242,89,251,103,116,20,100,120,111,37,11,62,54,582
North Carolina3,3,Kenny Williams,JR,G,North Carolina,ACC,35,1090,148,305,81,136,67,169,36,52,37,92,129,87,36,17,38,66,399
North Carolina4,4,Theo Pinson,SR,F,North Carolina,ACC,35,1030,122,260,110,210,12,50,105,128,51,172,223,169,38,19,84,79,361
North Carolina5,5,Cameron Johnson,,G,North Carolina,ACC,24,705,105,246,61,118,44,128,50,58,41,71,112,56,15,5,23,43,304
North Carolina6,6,Garrison Brooks,FR,F,North Carolina,ACC,35,511,62,114,62,114,0,0,33,58,60,65,125,17,10,11,32,64,157
North Carolina7,7,Sterling Manley,FR,F,North Carolina,ACC,35,349,68,121,68,121,0,0,53,77,49,73,122,11,2,23,31,43,189
North Carolina8,8,Brandon Robinson,SO,G,North Carolina,ACC,33,289,21,53,12,32,9,21,10,14,20,27,47,22,5,5,17,42,61
North Carolina9,9,Andrew Platek,FR,G,North Carolina,ACC,33,254,26,54,17,28,9,26,7,10,15,22,37,17,3,2,9,20,68
North Carolina10,10,Jalek Felton,FR,G,North Carolina,ACC,22,213,24,62,13,27,11,35,4,6,2,18,20,35,8,2,24,11,63
North Carolina11,11,Seventh Woods,SO,G,North Carolina,ACC,18,132,8,27,8,24,0,3,4,5,1,12,13,20,6,1,11,16,20
North Carolina12,12,Brandon Huffman,FR,F,North Carolina,ACC,27,96,18,33,18,33,0,0,9,16,15,24,39,1,0,8,13,18,45
North Carolina13,13,Aaron Rohlman,SR,F,North Carolina,ACC,19,29,3,3,3,3,0,0,0,1,2,6,8,2,0,0,2,1,6
North Carolina14,14,Shea Rush,SO,F,North Carolina,ACC,18,27,2,9,1,6,1,3,0,0,2,4,6,2,2,3,5,6,5
North Carolina15,15,Walker Miller,FR,F,North Carolina,ACC,18,27,2,6,2,6,0,0,1,1,1,6,7,4,0,2,2,3,5
North Carolina16,16,Kane Ma,,G,North Carolina,ACC,10,11,1,2,1,1,0,1,0,0,0,1,1,0,0,0,0,0,2
North Carolina A&T1,1,Kameron Langley,FR,G,North Carolina A&T,MEAC,34,1039,87,169,72,127,15,42,68,95,25,86,111,176,57,4,75,69,257
North Carolina A&T2,2,Femi Olujobi,JR,F,North Carolina A&T,MEAC,31,990,181,333,163,273,18,60,135,174,50,183,233,33,14,22,77,82,515
North Carolina A&T3,3,Devonte Boykins,SR,G,North Carolina A&T,MEAC,31,963,94,237,39,75,55,162,43,58,15,80,95,73,25,3,45,68,286
North Carolina A&T4,4,Denzel Keyes,SR,G,North Carolina A&T,MEAC,34,764,124,243,106,179,18,64,54,87,71,117,188,26,22,14,30,76,320
North Carolina A&T5,5,Aaren Edmead,SR,G,North Carolina A&T,MEAC,30,747,87,238,52,126,35,112,76,91,11,48,59,88,21,0,62,63,285
North Carolina A&T6,6,Davaris McGowens,SR,F,North Carolina A&T,MEAC,30,639,127,217,127,216,0,1,68,104,54,108,162,28,21,14,36,61,322
North Carolina A&T7,7,Kwei Lartey,JR,G,North Carolina A&T,MEAC,31,429,37,104,20,43,17,61,9,17,9,37,46,40,12,4,33,42,100
North Carolina A&T8,8,Japhet Kadji,SO,F,North Carolina A&T,MEAC,28,409,45,112,26,54,19,58,26,33,17,82,99,14,10,4,24,42,135
North Carolina A&T9,9,Amari Hamilton,JR,G,North Carolina A&T,MEAC,32,309,41,136,19,43,22,93,17,24,6,18,24,16,6,1,23,29,121
North Carolina A&T10,10,Milik Gantz,JR,G,North Carolina A&T,MEAC,29,245,39,76,37,62,2,14,23,36,8,30,38,16,8,7,27,36,103
North Carolina A&T11,11,Raymon Pratt,SO,G,North Carolina A&T,MEAC,22,174,27,43,26,38,1,5,20,32,12,10,22,4,2,0,12,28,75
North Carolina A&T12,12,Donte Watson,SR,G,North Carolina A&T,MEAC,11,82,12,28,9,18,3,10,5,7,1,11,12,0,2,2,5,2,32
North Carolina A&T13,13,Austin Williams,SR,G,North Carolina A&T,MEAC,10,43,4,10,2,6,2,4,0,3,0,2,2,7,6,0,4,7,10
North Carolina A&T14,14,D'Andre Johnson,,C,North Carolina A&T,MEAC,12,36,3,11,3,7,0,4,1,3,3,6,9,2,0,4,2,7,7
North Carolina A&T15,15,Dalen Dotson,SO,G,North Carolina A&T,MEAC,3,6,1,2,1,2,0,0,1,2,1,0,1,1,1,0,4,2,3
North Carolina Central1,1,Reginald Gardner,,G,North Carolina Central,MEAC,34,1006,122,352,46,120,76,232,57,75,17,44,61,56,13,6,37,60,377
North Carolina Central2,2,Raasean Davis,JR,C,North Carolina Central,MEAC,34,980,224,336,224,335,0,1,63,107,97,174,271,15,20,33,67,81,511
North Carolina Central3,3,Jordan Perkins,FR,PG,North Carolina Central,MEAC,34,925,100,225,79,173,21,52,65,91,23,76,99,184,18,9,92,96,286
North Carolina Central4,4,Pablo Rivas,JR,F,North Carolina Central,MEAC,32,847,147,293,105,175,42,118,42,55,56,164,220,33,24,35,36,91,378
North Carolina Central5,5,Larry McKnight,JR,G,North Carolina Central,MEAC,33,554,70,187,46,111,24,76,37,53,33,45,78,11,22,5,32,62,201
North Carolina Central6,6,Zacarry Douglas,JR,F,North Carolina Central,MEAC,30,406,48,100,36,66,12,34,19,28,34,97,131,18,4,12,26,48,127
North Carolina Central7,7,Brandon Goldsmith,JR,F,North Carolina Central,MEAC,25,403,37,90,33,71,4,19,24,38,14,50,64,20,17,5,33,42,102
North Carolina Central8,8,C.J. Wiggins,SO,G,North Carolina Central,MEAC,24,363,37,94,22,51,15,43,24,35,3,17,20,54,18,0,25,10,113
North Carolina Central9,9,Dominique Reid,SR,F,North Carolina Central,MEAC,32,361,58,100,57,98,1,2,29,45,31,76,107,13,3,7,41,57,146
North Carolina Central10,10,Alston Jones,JR,PG,North Carolina Central,MEAC,22,309,38,81,32,73,6,8,21,25,4,21,25,44,3,1,40,37,103
North Carolina Central11,11,John Guerra,SO,G,North Carolina Central,MEAC,22,259,22,58,14,35,8,23,22,29,16,20,36,14,8,0,10,22,74
North Carolina Central12,12,Raekwon Harney,JR,G,North Carolina Central,MEAC,21,250,15,45,12,33,3,12,1,6,3,22,25,58,19,0,22,16,34
North Carolina Central13,13,Marius McAllister,JR,G,North Carolina Central,MEAC,16,140,9,20,9,20,0,0,2,4,8,22,30,15,5,2,8,10,20
North Carolina Central14,14,Alex Mills,JR,G,North Carolina Central,MEAC,6,21,1,10,1,4,0,6,0,0,0,1,1,0,0,0,0,0,2
North Carolina State1,1,Allerik Freeman,,G,North Carolina State,ACC,32,1095,152,406,88,232,64,174,126,163,18,112,130,82,39,0,78,54,494
North Carolina State2,2,Braxton Beverly,FR,G,North Carolina State,ACC,30,972,97,243,37,91,60,152,40,48,18,57,75,119,30,0,37,78,294
North Carolina State3,3,Torin Dorn,JR,G,North Carolina State,ACC,32,915,173,321,153,254,20,67,74,100,76,120,196,43,32,13,64,75,440
North Carolina State4,4,Omer Yurtseven,SO,C,North Carolina State,ACC,32,772,186,323,164,280,22,43,49,80,89,131,220,15,16,60,36,94,443
North Carolina State5,5,Markell Johnson,SO,G,North Carolina State,ACC,25,726,76,167,51,107,25,60,42,68,15,69,84,186,43,6,83,58,219
North Carolina State6,6,Lennard Freeman,SR,F,North Carolina State,ACC,32,544,93,145,93,145,0,0,62,90,50,86,136,3,28,26,23,61,248
North Carolina State7,7,Sam Hunt,SR,G,North Carolina State,ACC,32,511,57,133,6,13,51,120,17,18,3,24,27,9,14,0,10,37,182
North Carolina State8,8,Lavar Batts Jr.,FR,G,North Carolina State,ACC,29,395,34,107,25,60,9,47,33,56,9,28,37,45,25,3,18,43,110
North Carolina State9,9,Abdul-Malik Abu,SR,F,North Carolina State,ACC,26,395,57,120,56,111,1,9,26,46,34,55,89,11,10,13,28,69,141
North Carolina State10,10,Shaun Kirk,JR,F,North Carolina State,ACC,5,55,5,15,5,12,0,3,1,2,4,10,14,3,2,1,2,6,11
North Carolina State11,11,Darius Hicks,SO,F,North Carolina State,ACC,4,34,7,10,7,10,0,0,3,4,9,3,12,1,1,0,0,3,17
North Carolina State12,12,Spencer Newman,,G,North Carolina State,ACC,6,11,0,3,0,1,0,2,0,0,1,3,4,0,0,0,1,1,0
North Carolina-Asheville1,1,Kevin Vannatta,SR,G,North Carolina-Asheville,Big South,33,1152,106,243,74,153,32,90,75,95,32,144,176,103,23,5,56,58,319
North Carolina-Asheville2,2,MaCio Teague,SO,G,North Carolina-Asheville,Big South,33,1151,172,409,81,192,91,217,108,125,16,130,146,84,53,4,67,55,543
North Carolina-Asheville3,3,Ahmad Thomas,SR,G,North Carolina-Asheville,Big South,31,983,214,426,197,365,17,61,70,105,48,130,178,87,58,11,73,85,515
North Carolina-Asheville4,4,Raekwon Miller,SR,G,North Carolina-Asheville,Big South,33,942,110,229,46,93,64,136,75,97,22,130,152,104,38,4,85,82,359
North Carolina-Asheville5,5,Jonathan Baehre,SO,F,North Carolina-Asheville,Big South,33,699,92,174,71,113,21,61,19,24,51,92,143,31,20,56,37,90,224
North Carolina-Asheville6,6,Alec Wnuk,SR,F,North Carolina-Asheville,Big South,33,664,72,151,69,135,3,16,28,44,27,58,85,42,10,5,56,87,175
North Carolina-Asheville7,7,Drew Rackley,SO,G,North Carolina-Asheville,Big South,32,474,49,109,20,44,29,65,19,28,5,27,32,30,18,2,24,47,146
North Carolina-Asheville8,8,Donovan Gilmore,JR,F,North Carolina-Asheville,Big South,27,281,33,60,33,60,0,0,22,36,19,59,78,7,9,9,19,49,88
North Carolina-Asheville9,9,Jalen Seegars,FR,G,North Carolina-Asheville,Big South,19,227,15,36,10,19,5,17,13,22,4,18,22,11,6,7,16,37,48
North Carolina-Asheville10,10,Justin Brown,SO,G,North Carolina-Asheville,Big South,12,65,10,20,9,12,1,8,9,9,3,8,11,2,2,2,5,16,30
North Carolina-Asheville11,11,Grant Townsend,SO,F,North Carolina-Asheville,Big South,5,31,3,6,3,6,0,0,1,8,5,2,7,0,0,4,3,4,7
North Carolina-Asheville12,12,L.J. Thorpe,FR,G,North Carolina-Asheville,Big South,1,6,1,2,1,1,0,1,3,4,0,1,1,2,4,0,2,0,5
North Carolina-Greensboro1,1,Francis Alonso,JR,G,North Carolina-Greensboro,Southern,34,994,169,406,59,138,110,268,83,95,15,65,80,101,36,2,86,78,531
North Carolina-Greensboro2,2,James Dickey,SO,F,North Carolina-Greensboro,Southern,33,910,115,214,115,214,0,0,63,106,95,180,275,44,26,69,79,81,293
North Carolina-Greensboro3,3,Marvin Smith,SR,F,North Carolina-Greensboro,Southern,34,908,129,346,54,120,75,226,84,111,55,128,183,29,28,14,41,83,417
North Carolina-Greensboro4,4,Jordy Kuiper,SR,F,North Carolina-Greensboro,Southern,33,901,84,211,46,101,38,110,28,42,54,101,155,37,20,11,38,80,234
North Carolina-Greensboro5,5,Demetrius Troy,JR,G,North Carolina-Greensboro,Southern,34,870,91,227,38,92,53,135,20,32,4,72,76,130,45,1,74,38,255
North Carolina-Greensboro6,6,Kyrin Galloway,SO,F,North Carolina-Greensboro,Southern,34,662,78,143,66,99,12,44,27,44,50,101,151,11,10,20,31,62,195
North Carolina-Greensboro7,7,Isaiah Miller,FR,G,North Carolina-Greensboro,Southern,34,554,127,232,126,223,1,9,33,52,47,62,109,51,47,2,45,78,288
North Carolina-Greensboro8,8,Malik Massey,SO,G,North Carolina-Greensboro,Southern,26,370,33,86,20,43,13,43,17,23,1,21,22,29,17,0,23,34,96
North Carolina-Greensboro9,9,Kylia Sykes,FR,G,North Carolina-Greensboro,Southern,34,351,27,50,20,28,7,22,8,13,21,24,45,21,20,9,20,53,69
North Carolina-Greensboro10,10,Garrett Collins,SR,F,North Carolina-Greensboro,Southern,32,230,31,70,12,13,19,57,9,10,13,25,38,4,7,3,6,19,90
North Carolina-Greensboro11,11,Justin Jordan,SR,G,North Carolina-Greensboro,Southern,20,167,9,18,9,18,0,0,3,4,2,19,21,23,7,0,11,15,21
North Carolina-Greensboro12,12,Lloyd Burgess,JR,C,North Carolina-Greensboro,Southern,5,33,3,3,3,3,0,0,3,7,5,4,9,0,0,0,4,7,9
North Carolina-Wilmington1,1,Ty Taylor II,SO,G,North Carolina-Wilmington,CAA,32,945,154,395,103,241,51,154,76,97,26,114,140,61,26,5,57,60,435
North Carolina-Wilmington2,2,Devontae Cacok,JR,F,North Carolina-Wilmington,CAA,32,942,221,378,221,378,0,0,123,201,162,269,431,28,33,18,72,124,565
North Carolina-Wilmington3,3,Jordon Talley,SR,G,North Carolina-Wilmington,CAA,31,939,179,423,104,236,75,187,91,113,16,71,87,176,30,2,78,94,524
North Carolina-Wilmington4,4,Jaylen Fornes,SO,G,North Carolina-Wilmington,CAA,32,902,127,289,77,155,50,134,75,100,48,80,128,64,16,6,64,77,379
North Carolina-Wilmington5,5,Marcus Bryan,SR,F,North Carolina-Wilmington,CAA,32,877,72,163,72,163,0,0,38,67,81,139,220,34,13,17,31,67,182
North Carolina-Wilmington6,6,Jay Estime',,G,North Carolina-Wilmington,CAA,32,626,59,160,30,62,29,98,19,26,26,56,82,33,12,3,30,55,166
North Carolina-Wilmington7,7,Jeffrey Gary,FR,G,North Carolina-Wilmington,CAA,32,543,41,108,16,34,25,74,10,12,12,40,52,42,13,1,30,36,117
North Carolina-Wilmington8,8,Jacque Brown,JR,G,North Carolina-Wilmington,CAA,29,302,28,81,22,56,6,25,13,23,4,17,21,36,15,1,23,24,75
North Carolina-Wilmington9,9,Trey Kalina,JR,C,North Carolina-Wilmington,CAA,25,147,20,41,20,41,0,0,8,15,13,16,29,1,1,13,11,26,48
North Carolina-Wilmington10,10,Nick Powell,SR,G,North Carolina-Wilmington,CAA,19,142,6,31,2,11,4,20,1,2,8,10,18,4,3,0,5,7,17
North Carolina-Wilmington11,11,JaQuel Richmond,JR,G,North Carolina-Wilmington,CAA,6,130,13,37,9,24,4,13,4,8,2,6,8,8,2,0,7,14,34
North Carolina-Wilmington12,12,Daniel Etoroma,JR,G,North Carolina-Wilmington,CAA,14,29,0,3,0,3,0,0,0,0,3,4,7,0,0,1,0,2,0
North Carolina-Wilmington13,13,Matt Elmore,,F,North Carolina-Wilmington,CAA,1,1,0,0,0,0,0,0,0,0,0,0,0,0,0,0,0,0,0
North Dakota1,1,Geno Crandall,JR,G,North Dakota,Big Sky,32,1068,179,356,129,236,50,120,123,169,32,108,140,114,67,3,105,97,531
North Dakota2,2,Cortez Seales,JR,G,North Dakota,Big Sky,31,1022,139,289,135,272,4,17,50,79,24,88,112,66,32,20,37,35,332
North Dakota3,3,Marlon Stewart,SO,G,North Dakota,Big Sky,32,900,120,278,87,169,33,109,100,131,11,74,85,94,42,2,73,80,373
North Dakota4,4,Conner Avants,JR,F,North Dakota,Big Sky,31,888,149,262,149,261,0,1,61,102,59,126,185,29,25,12,53,85,359
North Dakota5,5,Dale Jones,SR,F,North Dakota,Big Sky,30,782,120,276,52,95,68,181,47,57,20,175,195,31,18,10,49,98,355
North Dakota6,6,Billy Brown,SO,G,North Dakota,Big Sky,29,633,32,86,9,16,23,70,22,29,9,39,48,25,13,3,18,40,109
North Dakota7,7,Kienan Walter,SO,F,North Dakota,Big Sky,32,500,56,121,34,60,22,61,23,35,19,55,74,18,21,5,32,85,157
North Dakota8,8,Tray Buchanan,FR,G,North Dakota,Big Sky,31,371,45,130,20,51,25,79,30,38,7,25,32,21,27,0,26,45,145
North Dakota9,9,Jafar Kinsey,,G,North Dakota,Big Sky,26,261,17,59,13,26,4,33,11,21,7,20,27,11,6,1,13,24,49
North Dakota10,10,Garrett Franken,FR,F,North Dakota,Big Sky,12,66,3,11,0,2,3,9,0,0,0,9,9,0,2,2,1,8,9
North Dakota11,11,Carter Brooks,,F,North Dakota,Big Sky,1,21,1,7,0,2,1,5,0,0,0,2,2,0,0,0,1,3,3
North Dakota12,12,Jaqwan McCauley,JR,G,North Dakota,Big Sky,3,14,2,4,2,4,0,0,1,2,0,2,2,0,0,0,2,5,5
North Dakota State1,1,Paul Miller,SR,G,North Dakota State,Summit,31,1048,208,461,141,264,67,197,122,146,15,165,180,105,31,10,95,50,605
North Dakota State2,2,Tyson Ward,SO,G,North Dakota State,Summit,32,888,141,302,105,193,36,109,61,80,36,153,189,83,27,10,79,70,379
North Dakota State3,3,Cameron Hunter,FR,G,North Dakota State,Summit,32,883,89,202,48,104,41,98,76,99,3,94,97,76,28,0,67,75,295
North Dakota State4,4,A.J. Jacobson,SR,G,North Dakota State,Summit,32,826,97,202,42,79,55,123,54,60,10,120,130,51,13,11,27,61,303
North Dakota State5,5,Jared Samuelson,SO,G,North Dakota State,Summit,32,595,54,128,4,11,50,117,16,19,4,49,53,22,14,0,10,42,174
North Dakota State6,6,Spencer Eliason,JR,F,North Dakota State,Summit,32,571,57,102,57,102,0,0,17,37,49,59,108,17,10,12,29,83,131
North Dakota State7,7,Chris Quayle,SO,G,North Dakota State,Summit,32,483,34,89,13,32,21,57,8,9,7,51,58,26,7,3,22,30,97
North Dakota State8,8,Deng Geu,SO,F,North Dakota State,Summit,32,467,86,138,82,124,4,14,35,57,33,72,105,15,7,17,32,63,211
North Dakota State9,9,Rocky Kreuser,FR,F,North Dakota State,Summit,32,412,43,102,27,53,16,49,15,21,26,37,63,12,3,7,17,48,117
North Dakota State10,10,Dylan Miller,JR,F,North Dakota State,Summit,22,211,25,50,21,37,4,13,9,13,13,22,35,9,4,6,12,33,63
North Dakota State11,11,Nnamdi Van Dulm,SO,G,North Dakota State,Summit,6,41,3,7,3,6,0,1,1,3,0,10,10,6,1,0,2,1,7
North Florida1,1,Ivan Gandia-Rosa,SO,G,North Florida,A-Sun,33,1080,149,357,73,151,76,206,82,92,12,77,89,205,18,0,103,36,456
North Florida2,2,J.T. Escobar,SO,G,North Florida,A-Sun,33,889,130,285,39,71,91,214,29,33,9,55,64,36,22,2,57,58,380
North Florida3,3,Noah Horchler,SO,F,North Florida,A-Sun,33,867,156,283,133,217,23,66,52,86,80,206,286,44,18,54,47,78,387
North Florida4,4,Garrett Sams,SO,G,North Florida,A-Sun,28,777,112,270,57,130,55,140,77,96,18,102,120,38,19,6,70,59,356
North Florida5,5,Wajid Aminu,SO,F,North Florida,A-Sun,28,714,96,223,94,196,2,27,84,119,58,128,186,49,23,29,45,76,278
North Florida6,6,Osborn Blount,SR,G,North Florida,A-Sun,33,710,81,214,41,103,40,111,39,48,6,52,58,41,37,0,52,53,241
North Florida7,7,Trip Day,FR,F,North Florida,A-Sun,33,656,151,258,129,205,22,53,49,66,60,77,137,30,20,17,47,84,373
North Florida8,8,Ryan Burkhardt,FR,G,North Florida,A-Sun,31,440,35,79,0,4,35,75,5,7,3,33,36,27,6,2,18,20,110
North Florida9,9,Emmanuel Lambright,FR,G,North Florida,A-Sun,24,226,11,35,6,12,5,23,5,9,6,37,43,8,6,15,15,17,32
North Florida10,10,Brian Coffey II,FR,G,North Florida,A-Sun,22,172,9,32,6,18,3,14,7,9,5,7,12,11,4,0,14,17,28
North Florida11,11,Benedikt Haid,SO,G,North Florida,A-Sun,13,81,9,19,4,4,5,15,4,4,4,8,12,1,0,1,5,5,27
North Florida12,12,Chase Driscoll,SR,G,North Florida,A-Sun,7,13,0,3,0,2,0,1,0,1,0,1,1,0,0,0,0,2,0
North Texas1,1,Ryan Woolridge,SO,G,North Texas,CUSA,32,1180,167,333,150,284,17,49,72,139,34,138,172,174,43,12,113,68,423
North Texas2,2,Roosevelt Smart,SO,G,North Texas,CUSA,32,1064,180,452,70,163,110,289,129,148,14,115,129,25,19,7,57,78,599
North Texas3,3,A.J. Lawson,SO,G,North Texas,CUSA,31,854,122,298,110,245,12,53,55,103,47,123,170,72,26,9,70,101,311
North Texas4,4,Allante Holston,JR,G,North Texas,CUSA,32,659,42,97,37,84,5,13,23,35,29,80,109,40,16,5,36,48,112
North Texas5,5,Zachary Simmons,FR,F,North Texas,CUSA,31,610,75,120,75,119,0,1,29,53,61,65,126,12,10,19,30,108,179
North Texas6,6,Shane Temara,SR,F,North Texas,CUSA,29,599,88,190,57,97,31,93,18,34,46,92,138,15,5,20,21,42,225
North Texas7,7,DJ Draper,SO,G,North Texas,CUSA,28,541,53,111,8,8,45,103,15,21,9,31,40,19,19,0,18,51,166
North Texas8,8,Jorden Duffy,JR,G,North Texas,CUSA,20,347,43,122,20,48,23,74,16,22,8,43,51,18,4,1,16,24,125
North Texas9,9,Tope Arikawe,JR,F,North Texas,CUSA,28,316,41,78,41,78,0,0,30,47,42,55,97,2,7,11,21,52,112
North Texas10,10,Michael Miller,JR,G,North Texas,CUSA,24,205,15,47,12,24,3,23,13,16,15,27,42,12,1,2,16,26,46
North Texas11,11,Khalil Fuller,SO,F,North Texas,CUSA,14,60,6,8,6,8,0,0,0,1,2,10,12,1,3,0,4,13,12
North Texas12,12,Umoja Gibson,FR,G,North Texas,CUSA,2,40,8,21,4,11,4,10,1,2,3,5,8,4,3,1,2,4,21
North Texas13,13,Bryce Jackson,SR,F,North Texas,CUSA,8,24,0,4,0,0,0,4,2,2,2,6,8,0,0,0,4,4,2
Northeastern1,1,Vasa Pusica,JR,G,Northeastern,CAA,33,1132,189,375,113,197,76,178,138,171,9,111,120,168,36,4,113,74,592
Northeastern2,2,Shawn Occeus,SO,G,Northeastern,CAA,33,953,118,258,69,115,49,143,70,89,12,70,82,59,64,18,58,60,355
Northeastern3,3,Donnell Gresham Jr.,SO,G,Northeastern,CAA,33,915,91,223,25,70,66,153,51,65,14,133,147,63,25,5,28,47,299
Northeastern4,4,Bolden Brace,SO,G,Northeastern,CAA,33,812,82,178,27,39,55,139,42,51,24,133,157,72,21,14,42,68,261
Northeastern5,5,Devon Begley,SR,G,Northeastern,CAA,33,703,67,186,37,86,30,100,45,65,22,80,102,48,30,5,43,50,209
Northeastern6,6,Maxime Boursiquot,SO,G,Northeastern,CAA,33,648,87,168,74,128,13,40,22,32,35,91,126,42,25,7,47,85,209
Northeastern7,7,Anthony Green,JR,C,Northeastern,CAA,33,562,96,134,96,134,0,0,24,60,52,73,125,25,5,21,45,70,216
Northeastern8,8,Tomas Murphy,FR,F,Northeastern,CAA,33,533,88,155,84,139,4,16,37,49,39,40,79,26,4,3,31,72,217
Northeastern9,9,Jeremy Miller,JR,F,Northeastern,CAA,28,242,25,52,21,32,4,20,17,23,15,39,54,10,6,5,10,37,71
Northeastern10,10,Derrick Cook,FR,G,Northeastern,CAA,17,86,11,23,8,19,3,4,3,6,1,10,11,5,3,0,7,3,28
Northeastern11,11,Myles Franklin,FR,G,Northeastern,CAA,16,58,5,13,3,5,2,8,3,6,0,6,6,3,1,0,3,7,15
Northeastern12,12,Jason Strong,FR,F,Northeastern,CAA,10,31,0,11,0,8,0,3,0,0,1,1,2,2,0,0,2,2,0
Northern Arizona1,1,Gino Littles,SR,G,Northern Arizona,Big Sky,30,927,70,208,39,112,31,96,36,62,13,75,88,76,26,1,57,49,207
Northern Arizona2,2,Torry Johnson,JR,G,Northern Arizona,Big Sky,31,834,103,273,75,186,28,87,123,159,21,48,69,50,33,0,82,62,357
Northern Arizona3,3,Brooks DeBisschop,SO,F,Northern Arizona,Big Sky,29,800,55,140,46,106,9,34,33,63,63,153,216,31,25,13,49,74,152
Northern Arizona4,4,Chris Bowling,SO,G,Northern Arizona,Big Sky,31,737,86,247,41,108,45,139,23,32,11,71,82,35,22,12,54,61,240
Northern Arizona5,5,JoJo Anderson,SO,G,Northern Arizona,Big Sky,28,708,72,208,34,91,38,117,130,160,7,42,49,62,15,2,65,46,312
Northern Arizona6,6,Isaiah Thomas,JR,F,Northern Arizona,Big Sky,32,637,79,148,79,148,0,0,26,45,58,102,160,5,7,36,31,88,184
Northern Arizona7,7,Karl Harris,,G,Northern Arizona,Big Sky,32,584,90,235,77,177,13,58,68,83,15,56,71,21,17,3,43,74,261
Northern Arizona8,8,Corey Brown,JR,F,Northern Arizona,Big Sky,29,482,76,126,76,125,0,1,39,70,36,64,100,10,19,9,32,74,191
Northern Arizona9,9,Lenell Henry,FR,F,Northern Arizona,Big Sky,20,224,27,51,26,48,1,3,14,28,19,36,55,3,8,8,25,37,69
Northern Arizona10,10,Ruben Fuamba,JR,F,Northern Arizona,Big Sky,19,215,11,23,11,23,0,0,5,9,21,39,60,2,2,11,14,42,27
Northern Arizona11,11,Carlos Hines,,G,Northern Arizona,Big Sky,21,205,22,69,11,33,11,36,22,31,5,18,23,12,3,5,24,16,77
Northern Arizona12,12,Kye de Laveaga,JR,G,Northern Arizona,Big Sky,13,65,2,12,0,0,2,12,7,8,0,2,2,2,2,0,1,8,13
Northern Arizona13,13,Malcolm Allen,SR,G,Northern Arizona,Big Sky,3,31,5,9,5,9,0,0,0,0,0,0,0,5,1,0,3,1,10
Northern Arizona14,14,Omar Ndiaye,,G,Northern Arizona,Big Sky,1,1,0,1,0,0,0,1,0,0,0,0,0,0,0,0,0,0,0
Northern Colorado1,1,Jonah Radebaugh,SO,G,Northern Colorado,Big Sky,34,1209,90,193,33,61,57,132,35,50,42,168,210,46,32,12,26,77,272
Northern Colorado2,2,Andre Spight,SR,G,Northern Colorado,Big Sky,34,1138,255,575,149,311,106,264,129,159,19,115,134,125,38,8,100,67,745
Northern Colorado3,3,Jordan Davis,JR,G,Northern Colorado,Big Sky,34,967,208,404,193,344,15,60,107,172,36,111,147,100,30,14,102,93,538
Northern Colorado4,4,Jalen Sanders,FR,G,Northern Colorado,Big Sky,34,959,124,217,114,177,10,40,71,95,51,148,199,41,23,47,44,90,329
Northern Colorado5,5,Tanner Morgan,SR,F,Northern Colorado,Big Sky,34,801,84,178,80,160,4,18,38,60,54,142,196,21,15,21,45,112,210
Northern Colorado6,6,Anthony Johnson,SR,G,Northern Colorado,Big Sky,34,656,108,280,54,117,54,163,55,68,30,76,106,21,12,3,38,62,325
Northern Colorado7,7,Chaz Glotta,JR,G,Northern Colorado,Big Sky,32,427,49,118,14,24,35,94,7,16,3,25,28,24,8,0,14,40,140
Northern Colorado8,8,Roberto Vercellino,SO,F,Northern Colorado,Big Sky,27,288,21,42,20,29,1,13,17,23,24,40,64,11,7,11,13,44,60
Northern Colorado9,9,Kai Edwards,SO,F,Northern Colorado,Big Sky,24,167,19,28,19,28,0,0,11,25,19,34,53,7,2,2,5,25,49
Northern Colorado10,10,Matej Drgon,FR,F,Northern Colorado,Big Sky,19,128,12,43,2,7,10,36,2,3,7,16,23,2,1,1,8,22,36
Northern Colorado11,11,Johnatan Reyes,FR,G,Northern Colorado,Big Sky,17,59,8,17,6,12,2,5,6,8,1,6,7,7,3,0,9,4,24
Northern Colorado12,12,Ibrahim Sylla,JR,F,Northern Colorado,Big Sky,14,41,3,6,3,6,0,0,2,11,4,9,13,0,0,3,6,10,8
Northern Colorado13,13,Tyler Loose,SR,G,Northern Colorado,Big Sky,14,35,1,3,1,3,0,0,0,1,1,4,5,2,0,0,2,3,2
Northern Illinois1,1,Eugene German,SO,G,Northern Illinois,MAC,32,991,243,516,181,333,62,183,111,144,13,110,123,54,28,5,66,52,659
Northern Illinois2,2,Levi Bradley,JR,G,Northern Illinois,MAC,32,947,162,379,136,286,26,93,116,140,41,135,176,24,28,8,42,88,466
Northern Illinois3,3,Justin Thomas,SO,G,Northern Illinois,MAC,32,844,68,152,47,98,21,54,35,57,13,77,90,61,42,3,33,45,192
Northern Illinois4,4,Dante Thorpe,JR,G,Northern Illinois,MAC,28,782,124,234,108,193,16,41,37,53,30,61,91,49,24,8,52,62,301
Northern Illinois5,5,Gairges Daow,FR,G,Northern Illinois,MAC,32,699,48,121,32,72,16,49,27,36,31,88,119,26,21,5,34,68,139
Northern Illinois6,6,Lacey James,JR,F,Northern Illinois,MAC,32,686,61,154,61,153,0,1,62,89,57,93,150,17,21,7,58,105,184
Northern Illinois7,7,Noah McCarty,SO,F,Northern Illinois,MAC,32,531,48,116,40,83,8,33,26,43,36,66,102,18,17,10,32,69,130
Northern Illinois8,8,Anastasios Demogerontas,JR,G,Northern Illinois,MAC,30,450,45,95,38,73,7,22,22,33,23,40,63,21,20,3,28,39,119
Northern Illinois9,9,Rod Henry-Hayes,FR,G,Northern Illinois,MAC,24,210,17,38,7,9,10,29,6,8,5,12,17,15,4,2,5,21,50
Northern Illinois10,10,Owen Hamilton,FR,C,Northern Illinois,MAC,27,184,22,34,22,33,0,1,6,12,11,24,35,3,7,3,10,30,50
Northern Illinois11,11,Andrew Zelis,SR,C,Northern Illinois,MAC,11,65,7,14,7,14,0,0,2,4,6,4,10,3,0,4,3,11,16
Northern Illinois12,12,Brandon Danowski,FR,G,Northern Illinois,MAC,9,16,2,2,1,1,1,1,2,3,0,2,2,1,1,0,3,1,7
Northern Illinois13,13,Jon Siu,JR,G,Northern Illinois,MAC,4,12,2,4,0,0,2,4,0,0,0,2,2,1,0,0,1,2,6
Northern Illinois14,14,Brennen Woods,FR,F,Northern Illinois,MAC,3,5,0,0,0,0,0,0,0,0,0,1,1,1,0,0,1,0,0
Northern Illinois15,15,Marlo Brown,,G,Northern Illinois,MAC,1,2,0,0,0,0,0,0,0,0,0,0,0,0,0,0,0,0,0
Northern Illinois16,16,Caleb Oehlberg,,G,Northern Illinois,MAC,1,1,0,1,0,0,0,1,0,0,0,0,0,1,0,0,0,0,0
Northern Iowa1,1,Klint Carlson,SR,F,Northern Iowa,MVC,32,1042,120,285,86,178,34,107,40,58,40,159,199,51,21,11,58,73,314
Northern Iowa2,2,Tywhon Pickford,FR,G,Northern Iowa,MVC,32,951,102,274,72,151,30,123,58,75,60,188,248,40,20,11,35,33,292
Northern Iowa3,3,Isaiah Brown,SO,G,Northern Iowa,MVC,32,812,71,197,38,95,33,102,23,33,11,86,97,51,26,12,50,64,198
Northern Iowa4,4,Bennett Koch,SR,F,Northern Iowa,MVC,31,749,134,241,134,241,0,0,127,173,59,130,189,16,21,26,61,72,395
Northern Iowa5,5,Juwan McCloud,SO,G,Northern Iowa,MVC,26,673,67,189,49,118,18,71,19,35,5,40,45,62,33,2,43,43,171
Northern Iowa6,6,Wyatt Lohaus,,G,Northern Iowa,MVC,24,571,73,173,30,78,43,95,33,44,3,59,62,33,8,0,24,42,222
Northern Iowa7,7,Spencer Haldeman,SO,G,Northern Iowa,MVC,31,549,56,138,13,34,43,104,34,48,4,40,44,35,14,0,27,46,189
Northern Iowa8,8,Hunter Rhodes,SR,G,Northern Iowa,MVC,23,393,28,78,14,34,14,44,25,27,2,35,37,30,8,0,7,31,95
Northern Iowa9,9,Austin Phyfe,FR,F,Northern Iowa,MVC,28,274,32,52,29,46,3,6,22,30,19,26,45,7,1,4,12,41,89
Northern Iowa10,10,Ted Friedman,SR,C,Northern Iowa,MVC,23,156,11,20,9,16,2,4,2,5,14,11,25,6,2,6,7,22,26
Northern Iowa11,11,Adam McDermott,SO,G,Northern Iowa,MVC,9,78,5,14,0,2,5,12,1,1,0,8,8,4,4,0,2,3,16
Northern Iowa12,12,Luke McDonnell,SO,F,Northern Iowa,MVC,11,64,11,20,11,15,0,5,0,3,3,12,15,2,3,7,4,7,22
Northern Iowa13,13,Miles Wentzien,JR,G,Northern Iowa,MVC,5,55,5,15,3,9,2,6,1,1,1,4,5,6,3,0,7,2,13
Northern Iowa14,14,Tanner Lohaus,FR,F,Northern Iowa,MVC,7,35,2,8,0,4,2,4,2,4,3,7,10,2,1,1,0,2,8
Northern Iowa15,15,Lincoln Conrey,SO,F,Northern Iowa,MVC,5,13,3,5,3,4,0,1,0,0,1,1,2,0,1,0,0,0,6
Northern Iowa16,16,Justin Dahl,SO,C,Northern Iowa,MVC,3,10,0,5,0,5,0,0,0,0,2,0,2,0,0,0,2,0,0
Northern Kentucky1,1,Drew McDonald,JR,F,Northern Kentucky,Horizon,31,945,189,403,136,249,53,154,94,118,59,236,295,70,16,16,65,70,525
Northern Kentucky2,2,LaVone Holland,SR,G,Northern Kentucky,Horizon,31,932,142,339,87,185,55,154,89,106,15,113,128,139,34,7,81,69,428
Northern Kentucky3,3,Jordan Garnett,SR,F,Northern Kentucky,Horizon,31,899,72,151,34,59,38,92,24,35,27,67,94,63,26,12,32,77,206
Northern Kentucky4,4,Carson Williams,SO,F,Northern Kentucky,Horizon,31,840,150,247,143,228,7,19,74,114,59,118,177,38,29,14,44,51,381
Northern Kentucky5,5,Jalen Tate,FR,F,Northern Kentucky,Horizon,31,703,70,148,64,120,6,28,35,53,9,61,70,62,41,19,36,101,181
Northern Kentucky6,6,Mason Faulkner,SO,G,Northern Kentucky,Horizon,31,543,58,139,26,50,32,89,30,34,7,52,59,70,23,0,43,53,178
Northern Kentucky7,7,Dantez Walton,SO,G,Northern Kentucky,Horizon,31,494,65,145,51,79,14,66,19,31,42,57,99,32,20,14,25,57,163
Northern Kentucky8,8,Tyler Sharpe,SO,G,Northern Kentucky,Horizon,30,441,63,145,17,28,46,117,32,42,6,27,33,19,26,3,15,43,204
Northern Kentucky9,9,Jeff Garrett,JR,F,Northern Kentucky,Horizon,27,247,51,81,51,78,0,3,14,25,39,49,88,4,9,13,18,22,116
Northern Kentucky10,10,Tre Cobbs,SO,G,Northern Kentucky,Horizon,15,85,10,14,8,10,2,4,10,13,0,5,5,8,1,0,8,15,32
Northern Kentucky11,11,Chris Vogt,FR,C,Northern Kentucky,Horizon,14,49,6,10,6,8,0,2,2,6,0,8,8,4,2,4,2,8,14
Northern Kentucky12,12,Nick Ayers,SR,G,Northern Kentucky,Horizon,8,18,0,2,0,2,0,0,0,0,0,6,6,1,1,0,0,1,0
Northern Kentucky13,13,Darian Childress,,F,Northern Kentucky,Horizon,4,4,0,1,0,1,0,0,0,0,0,0,0,0,0,0,1,0,0
Northwestern1,1,Scottie Lindsey,SR,G,Northwestern,Big Ten,32,1026,169,424,90,206,79,218,68,82,24,99,123,54,15,14,52,82,485
Northwestern2,2,Dererk Pardon,JR,C,Northwestern,Big Ten,32,992,143,231,143,230,0,1,75,122,106,121,227,38,18,56,45,93,361
Northwestern3,3,Bryant McIntosh,SR,G,Northwestern,Big Ten,29,908,127,327,88,210,39,117,49,58,13,56,69,148,13,3,74,46,342
Northwestern4,4,Vic Law,JR,F,Northwestern,Big Ten,27,853,109,261,58,128,51,133,56,68,30,126,156,60,29,15,45,73,325
Northwestern5,5,Gavin Skelly,SR,F,Northwestern,Big Ten,32,697,66,150,42,92,24,58,40,56,35,93,128,32,24,17,45,86,196
Northwestern6,6,Anthony Gaines,FR,G,Northwestern,Big Ten,32,597,42,112,34,79,8,33,37,47,24,57,81,37,17,4,29,52,129
Northwestern7,7,Aaron Falzon,SO,F,Northwestern,Big Ten,28,447,45,129,9,33,36,96,29,34,8,40,48,15,9,6,15,37,155
Northwestern8,8,Jordan Ash,JR,G,Northwestern,Big Ten,25,319,19,52,8,18,11,34,3,5,3,26,29,18,14,0,13,25,52
Northwestern9,9,Barret Benson,SO,C,Northwestern,Big Ten,32,306,21,38,21,37,0,1,17,32,22,48,70,14,7,18,18,68,59
Northwestern10,10,Isiah Brown,SO,G,Northwestern,Big Ten,25,270,32,81,25,55,7,26,27,31,5,17,22,30,9,0,25,38,98
Northwestern11,11,Tino Malnati,FR,G,Northwestern,Big Ten,9,12,0,4,0,3,0,1,0,0,0,2,2,1,1,1,1,0,0
Northwestern12,12,Charlie Hall,JR,F,Northwestern,Big Ten,4,12,0,2,0,0,0,2,1,3,0,1,1,0,0,2,0,0,1
Northwestern13,13,Rapolas Ivanauskas,FR,F,Northwestern,Big Ten,3,11,0,2,0,2,0,0,0,0,0,3,3,0,0,0,0,5,0
Northwestern State1,1,Ishmael Lane,JR,F,Northwestern State,Southland,29,749,149,281,132,236,17,45,82,128,69,141,210,24,25,53,71,76,397
Northwestern State2,2,C.J. Jones,FR,G,Northwestern State,Southland,29,715,52,158,36,102,16,56,38,60,3,28,31,39,17,1,48,46,158
Northwestern State3,3,Iziahiah Sweeney,SR,G,Northwestern State,Southland,27,683,116,289,95,205,21,84,48,70,33,64,97,37,26,9,59,70,301
Northwestern State4,4,Malik Metoyer,JR,G,Northwestern State,Southland,25,528,48,114,40,80,8,34,19,32,38,69,107,26,16,13,32,65,123
Northwestern State5,5,Larry Owens,FR,C,Northwestern State,Southland,29,490,75,155,75,154,0,1,33,68,30,88,118,10,11,16,46,41,183
Northwestern State6,6,Brandon Hutton,,F,Northwestern State,Southland,28,477,39,115,34,95,5,20,31,52,33,40,73,21,16,13,50,72,114
Northwestern State7,7,Darian Dixon,FR,F,Northwestern State,Southland,29,461,46,81,46,80,0,1,48,76,43,45,88,8,12,12,28,54,140
Northwestern State8,8,Czar Perry,FR,G,Northwestern State,Southland,14,299,52,120,44,86,8,34,15,27,8,21,29,26,6,1,55,30,127
Northwestern State9,9,Vontay Ott,FR,G,Northwestern State,Southland,27,263,25,83,17,48,8,35,6,17,14,31,45,12,9,1,27,25,64
Northwestern State10,10,Caleb Starks,FR,G,Northwestern State,Southland,27,256,17,56,15,42,2,14,6,11,14,15,29,9,5,0,22,26,42
Northwestern State11,11,Jalan West,SR,G,Northwestern State,Southland,8,231,30,71,6,21,24,50,14,15,5,23,28,37,13,0,12,8,98
Northwestern State12,12,Devonte Hall,SR,G,Northwestern State,Southland,8,189,14,49,7,23,7,26,11,17,5,18,23,18,8,0,10,18,46
Northwestern State13,13,DeAndre Love,,G,Northwestern State,Southland,11,157,17,45,15,39,2,6,4,6,10,17,27,1,2,1,5,9,40
Northwestern State14,14,Jacob Guest,SO,G,Northwestern State,Southland,22,150,10,48,3,12,7,36,3,4,0,14,14,4,3,1,14,10,30
Northwestern State15,15,Cameron Lazare,,G,Northwestern State,Southland,16,117,1,10,1,5,0,5,0,2,4,12,16,6,9,1,5,18,2
Northwestern State16,16,Bailey Walker,JR,G,Northwestern State,Southland,4,35,1,3,1,2,0,1,1,3,1,2,3,1,2,0,2,5,3
Notre Dame1,1,Temple Gibbs,SO,G,Notre Dame,ACC,34,1281,159,388,83,196,76,192,124,149,22,71,93,106,33,2,52,58,518
Notre Dame2,2,Rex Pflueger,JR,G,Notre Dame,ACC,33,1099,90,246,51,124,39,122,55,71,40,99,139,102,36,7,51,64,274
Notre Dame3,3,Matt Farrell,SR,G,Notre Dame,ACC,29,1036,160,378,64,137,96,241,71,87,6,66,72,159,30,2,67,41,487
Notre Dame4,4,Martinas Geben,SR,F,Notre Dame,ACC,34,849,146,244,145,241,1,3,79,93,102,174,276,39,20,31,56,68,372
Notre Dame5,5,Bonzie Colson,SR,F,Notre Dame,ACC,19,628,146,290,130,235,16,55,76,99,43,148,191,18,34,43,30,34,384
Notre Dame6,6,John Mooney,SO,F,Notre Dame,ACC,34,522,70,142,39,74,31,68,24,45,41,92,133,16,10,11,12,54,195
Notre Dame7,7,Nikola Djogo,SO,G,Notre Dame,ACC,30,457,26,90,13,38,13,52,11,21,16,42,58,20,7,7,15,30,76
Notre Dame8,8,D.J. Harvey,FR,G,Notre Dame,ACC,19,345,39,100,24,55,15,45,18,29,14,42,56,11,11,3,11,21,111
Notre Dame9,9,Elijah Burns,JR,F,Notre Dame,ACC,29,308,22,54,21,50,1,4,23,30,19,47,66,7,6,3,14,19,68
Notre Dame10,10,Austin Torres,SR,F,Notre Dame,ACC,29,305,29,48,29,48,0,0,3,16,22,46,68,11,9,10,14,49,61
Notre Dame11,11,Matt Gregory,SR,F,Notre Dame,ACC,15,29,1,10,0,4,1,6,0,0,1,2,3,0,0,0,0,1,3
Notre Dame12,12,Liam Nelligan,SR,G,Notre Dame,ACC,11,17,1,2,1,1,0,1,0,0,2,1,3,0,0,2,0,0,2
Oakland1,1,Kendrick Nunn,SR,G,Oakland,Horizon,30,1136,262,602,128,262,134,340,119,142,27,115,142,113,45,11,88,67,777
Oakland2,2,Jalen Hayes,SR,F,Oakland,Horizon,29,1036,212,404,207,381,5,23,117,141,68,167,235,57,29,25,70,93,546
Oakland3,3,Martez Walker,SR,G,Oakland,Horizon,26,965,138,299,84,137,54,162,127,163,28,78,106,42,23,15,45,50,457
Oakland4,4,Isaiah Brock,SO,F,Oakland,Horizon,30,847,71,101,71,101,0,0,20,31,68,176,244,18,17,84,23,82,162
Oakland5,5,Nick Daniels,SR,G,Oakland,Horizon,33,830,82,225,22,64,60,161,57,79,11,79,90,129,33,2,71,68,281
Oakland6,6,Brailen Neely,SO,G,Oakland,Horizon,24,511,29,68,22,44,7,24,30,35,6,38,44,133,27,2,51,37,95
Oakland7,7,Chris Palombizio,SO,F,Oakland,Horizon,33,397,29,95,17,45,12,50,18,32,19,44,63,11,8,2,9,31,88
Oakland8,8,James Beck,FR,G,Oakland,Horizon,19,287,24,70,24,66,0,4,15,24,20,49,69,9,3,4,16,35,63
Oakland9,9,Stan Scott,FR,G,Oakland,Horizon,23,230,20,43,20,43,0,0,15,21,11,29,40,24,10,5,27,26,55
Oakland10,10,Julius Palmer,JR,F,Oakland,Horizon,26,183,8,21,8,21,0,0,12,17,15,27,42,3,2,15,8,31,28
Oakland11,11,Tom Cotter,SR,F,Oakland,Horizon,15,90,5,13,5,13,0,0,3,5,6,18,24,1,0,0,3,10,13
Oakland12,12,Jaevin Cumberland,JR,G,Oakland,Horizon,8,74,2,14,1,7,1,7,4,7,4,6,10,6,2,0,6,7,9
Oakland13,13,Chris Gilbert,FR,G,Oakland,Horizon,10,64,2,11,0,0,2,11,0,0,0,3,3,7,1,0,0,3,6
Ohio1,1,Teyvion Kirk,FR,G,Ohio,MAC,31,993,160,365,144,325,16,40,137,190,34,154,188,95,42,5,106,77,473
Ohio2,2,Mike Laster,SR,G,Ohio,MAC,30,992,164,344,110,206,54,138,53,74,14,73,87,58,17,5,45,58,435
Ohio3,3,Gavin Block,JR,G,Ohio,MAC,31,943,89,243,40,93,49,150,37,62,17,111,128,106,23,10,50,74,264
Ohio4,4,Jordan Dartis,JR,G,Ohio,MAC,29,886,124,288,46,104,78,184,55,65,12,91,103,62,34,4,40,58,381
Ohio5,5,Doug Taylor,JR,F,Ohio,MAC,31,745,94,166,93,163,1,3,25,47,73,149,222,21,17,60,43,88,214
Ohio6,6,James Gollon,SO,G,Ohio,MAC,31,669,67,147,32,56,35,91,42,48,16,94,110,40,31,5,37,51,211
Ohio7,7,Kevin Mickle,SR,F,Ohio,MAC,28,584,98,203,93,185,5,18,37,56,33,71,104,25,23,12,36,50,238
Ohio8,8,Zach Butler,FR,G,Ohio,MAC,30,400,30,84,26,64,4,20,12,17,0,45,45,29,14,1,33,31,76
Ohio9,9,A.J. Gareri,,F,Ohio,MAC,10,61,2,9,1,4,1,5,4,6,0,7,7,1,0,0,4,4,9
Ohio10,10,Jason Carter,,F,Ohio,MAC,3,42,5,17,5,14,0,3,10,12,1,8,9,5,5,0,3,3,20
Ohio11,11,Ellis Dozier,SO,F,Ohio,MAC,11,39,3,12,3,10,0,2,0,1,2,2,4,0,0,0,1,6,6
Ohio12,12,Jaylin McDonald,JR,F,Ohio,MAC,7,15,0,1,0,1,0,0,0,0,1,3,4,0,1,0,0,0,0
Ohio13,13,Sam Frayer,SR,F,Ohio,MAC,6,14,3,9,2,4,1,5,0,0,1,5,6,0,0,0,0,0,7
Ohio14,14,Antonio Bisutti,SR,G,Ohio,MAC,6,13,0,5,0,3,0,2,0,0,0,0,0,1,0,0,0,0,0
Ohio15,15,C.J. Rhodes,,G,Ohio,MAC,2,4,0,0,0,0,0,0,0,0,0,0,0,0,0,0,0,0,0
Ohio State1,1,Keita Bates-Diop,JR,F,Ohio State,Big Ten,32,1045,230,475,172,313,58,162,102,131,47,234,281,54,31,53,56,55,620
Ohio State2,2,C.J. Jackson,JR,G,Ohio State,Big Ten,32,971,130,310,72,157,58,153,72,88,16,104,120,123,33,7,69,69,390
Ohio State3,3,Jae'Sean Tate,,F,Ohio State,Big Ten,32,954,163,293,154,260,9,33,64,107,40,158,198,92,33,19,73,98,399
Ohio State4,4,Kaleb Wesson,FR,F,Ohio State,Big Ten,31,663,117,206,113,192,4,14,97,135,74,86,160,35,16,21,31,88,335
Ohio State5,5,Kam Williams,SR,G,Ohio State,Big Ten,29,661,90,185,53,101,37,84,20,25,5,52,57,20,14,5,17,28,237
Ohio State6,6,Andrew Dakich,SR,G,Ohio State,Big Ten,32,597,34,67,20,36,14,31,12,16,11,45,56,68,27,1,33,35,94
Ohio State7,7,Andre Wesson,SO,F,Ohio State,Big Ten,32,580,33,80,17,30,16,50,13,18,18,37,55,36,10,3,36,73,95
Ohio State8,8,Musa Jallow,FR,G,Ohio State,Big Ten,31,453,31,78,20,35,11,43,9,14,15,32,47,27,16,4,29,48,82
Ohio State9,9,Micah Potter,SO,C,Ohio State,Big Ten,27,282,43,88,38,69,5,19,24,30,29,40,69,10,5,11,12,38,115
Ohio State10,10,Kyle Young,FR,F,Ohio State,Big Ten,25,216,19,43,18,33,1,10,5,11,19,21,40,4,7,3,9,19,44
Ohio State11,11,Joey Lane,JR,G,Ohio State,Big Ten,9,26,3,11,1,4,2,7,3,4,0,4,4,2,1,0,2,4,11
Ohio State12,12,Matt Lehmann,JR,G,Ohio State,Big Ten,5,11,1,4,0,0,1,4,0,0,1,1,2,1,0,0,1,1,3
Ohio State13,13,Connor Fulton,FR,G,Ohio State,Big Ten,4,9,0,2,0,0,0,2,1,2,0,1,1,0,0,0,1,0,1
Oklahoma1,1,Trae Young,FR,G,Oklahoma,Big 12,31,1094,252,599,137,281,115,318,229,266,13,107,120,271,53,8,161,55,848
Oklahoma2,2,Christian James,JR,G,Oklahoma,Big 12,30,905,130,281,73,125,57,156,46,60,33,97,130,46,34,1,45,80,363
Oklahoma3,3,Brady Manek,FR,F,Oklahoma,Big 12,31,740,122,256,63,105,59,151,18,30,36,122,158,15,11,21,23,30,321
Oklahoma4,4,Khadeem Lattin,SR,F,Oklahoma,Big 12,31,630,82,137,82,136,0,1,46,61,59,126,185,16,36,59,22,84,210
Oklahoma5,5,Rashard Odomes,JR,G,Oklahoma,Big 12,30,622,85,165,78,150,7,15,41,76,48,54,102,32,10,2,26,53,218
Oklahoma6,6,Kameron McGusty,SO,G,Oklahoma,Big 12,31,569,86,204,52,106,34,98,41,54,12,49,61,9,11,1,25,32,247
Oklahoma7,7,Jamuni McNeace,JR,C,Oklahoma,Big 12,31,543,89,132,89,132,0,0,25,44,40,123,163,11,18,44,47,75,203
Oklahoma8,8,Kristian Doolittle,,F,Oklahoma,Big 12,21,347,20,56,18,52,2,4,14,24,19,63,82,14,8,3,14,29,56
Oklahoma9,9,Jordan Shepherd,SO,G,Oklahoma,Big 12,30,342,20,54,14,35,6,19,22,29,1,20,21,37,13,4,24,35,68
Oklahoma10,10,Matt Freeman,SO,F,Oklahoma,Big 12,26,245,23,62,9,19,14,43,6,8,5,29,34,11,4,2,8,30,66
Oklahoma11,11,Ty Lazenby,JR,G,Oklahoma,Big 12,26,131,6,20,4,11,2,9,1,2,4,12,16,4,5,0,8,19,15
Oklahoma12,12,Hannes Polla,FR,C,Oklahoma,Big 12,16,49,8,17,8,17,0,0,1,2,9,8,17,1,0,1,5,9,17
Oklahoma13,13,Chris Giles,FR,G,Oklahoma,Big 12,8,15,2,7,2,6,0,1,2,2,0,0,0,0,1,0,1,1,6
Oklahoma14,14,Patrick Geha,JR,F,Oklahoma,Big 12,5,10,0,3,0,3,0,0,2,2,0,2,2,0,0,0,0,0,2
Oklahoma15,15,Marshall Thorpe,SO,F,Oklahoma,Big 12,4,8,0,0,0,0,0,0,0,0,0,2,2,0,0,0,0,1,0
Oklahoma State1,1,Jeffrey Carroll,SR,G,Oklahoma State,Big 12,30,924,154,375,94,192,60,183,86,113,47,139,186,51,24,7,62,50,454
Oklahoma State2,2,Lindy Waters,SO,G,Oklahoma State,Big 12,32,864,95,213,49,89,46,124,40,51,23,93,116,60,28,13,41,81,276
Oklahoma State3,3,Kendall Smith,SR,G,Oklahoma State,Big 12,32,850,154,369,111,260,43,109,62,90,16,78,94,92,31,0,69,55,413
Oklahoma State4,4,Mitchell Solomon,SR,F,Oklahoma State,Big 12,33,789,105,191,99,162,6,29,58,67,104,107,211,48,31,34,53,111,274
Oklahoma State5,5,Cameron McGriff,SO,F,Oklahoma State,Big 12,33,782,91,182,71,132,20,50,85,98,71,108,179,28,26,19,45,84,287
Oklahoma State6,6,Tavarius Shine,JR,G,Oklahoma State,Big 12,28,717,89,222,53,106,36,116,56,72,35,61,96,50,27,19,32,61,270
Oklahoma State7,7,Brandon Averette,SO,G,Oklahoma State,Big 12,33,673,78,193,68,158,10,35,42,57,5,53,58,95,22,1,45,50,208
Oklahoma State8,8,Yankuba Sima,,F,Oklahoma State,Big 12,24,361,39,76,39,75,0,1,14,32,36,43,79,9,12,28,29,60,92
Oklahoma State9,9,Thomas Dziagwa,SO,G,Oklahoma State,Big 12,33,343,54,147,7,24,47,123,15,16,5,32,37,16,10,1,23,34,170
Oklahoma State10,10,Lucas N'Guessan,,F,Oklahoma State,Big 12,24,242,12,23,12,21,0,2,13,22,13,34,47,9,7,11,12,37,37
Oklahoma State11,11,Zack Dawson,FR,G,Oklahoma State,Big 12,5,50,7,17,5,10,2,7,6,9,0,4,4,8,0,0,8,6,22
Oklahoma State12,12,Davon Dillard,JR,G,Oklahoma State,Big 12,4,33,6,10,5,8,1,2,4,4,3,2,5,0,0,0,3,3,17
Oklahoma State13,13,Trey Reeves,SO,F,Oklahoma State,Big 12,8,22,1,5,1,3,0,2,0,0,0,2,2,0,0,0,2,3,2
Old Dominion1,1,Ahmad Caver,JR,G,Old Dominion,CUSA,32,1189,155,380,90,194,65,186,78,117,19,94,113,197,73,5,65,52,453
Old Dominion2,2,B.J. Stith,JR,G,Old Dominion,CUSA,32,1006,157,359,101,220,56,139,85,101,24,157,181,55,25,5,50,58,455
Old Dominion3,3,Randy Haynes,SR,G,Old Dominion,CUSA,32,957,145,375,80,173,65,202,35,51,31,88,119,78,43,8,46,82,390
Old Dominion4,4,Brandan Stith,SR,F,Old Dominion,CUSA,32,874,118,220,118,219,0,1,44,69,98,149,247,40,35,52,48,74,280
Old Dominion5,5,Trey Porter,JR,F,Old Dominion,CUSA,32,756,146,249,145,248,1,1,128,191,79,118,197,16,15,43,41,88,421
Old Dominion6,6,Xavier Green,FR,G,Old Dominion,CUSA,31,691,55,142,40,97,15,45,32,44,10,54,64,56,24,2,31,58,157
Old Dominion7,7,Aaron Carver,SO,F,Old Dominion,CUSA,31,564,26,59,26,57,0,2,15,30,43,81,124,20,15,22,22,58,67
Old Dominion8,8,Keith Pinckney,SR,G,Old Dominion,CUSA,20,108,9,29,7,21,2,8,3,7,2,5,7,9,4,0,7,10,23
Old Dominion9,9,Stephen Vassor,SR,F,Old Dominion,CUSA,18,108,6,11,6,11,0,0,4,4,8,14,22,1,3,1,6,16,16
Old Dominion10,10,Marquis Godwin,FR,G,Old Dominion,CUSA,18,91,15,39,1,4,14,35,6,6,0,14,14,1,0,1,3,8,50
Old Dominion11,11,Michael Hueitt Jr,FR,G,Old Dominion,CUSA,13,77,9,22,0,3,9,19,0,0,5,22,27,7,1,0,2,2,27
Old Dominion12,12,Alfis Pilavios,FR,F,Old Dominion,CUSA,9,19,1,1,0,0,1,1,1,2,3,2,5,3,1,0,0,2,4
Old Dominion13,13,Greg McClinton,,F,Old Dominion,CUSA,2,10,2,2,2,2,0,0,0,1,1,2,3,0,0,0,1,1,4
Oral Roberts1,1,Sam Kearns,SO,G,Oral Roberts,Summit,32,1058,106,289,36,90,70,199,43,52,13,64,77,131,18,1,69,83,325
Oral Roberts2,2,Emmanuel Nzekwesi,SO,F,Oral Roberts,Summit,32,974,161,355,146,291,15,64,69,102,85,144,229,55,38,21,68,70,406
Oral Roberts3,3,Javan White,SO,F,Oral Roberts,Summit,32,881,132,257,126,242,6,15,57,103,113,174,287,43,30,21,50,76,327
Oral Roberts4,4,R.J. Fuqua,FR,G,Oral Roberts,Summit,27,794,75,214,47,127,28,87,37,48,8,64,72,79,31,3,55,60,215
Oral Roberts5,5,Albert Owens,SR,C,Oral Roberts,Summit,31,763,149,307,148,305,1,2,59,85,57,73,130,21,14,49,41,45,358
Oral Roberts6,6,Austin Ruder,SR,G,Oral Roberts,Summit,22,698,80,220,17,48,63,172,16,20,5,61,66,50,17,0,21,39,239
Oral Roberts7,7,Jontray Harris,JR,G,Oral Roberts,Summit,30,679,60,147,34,76,26,71,30,35,39,88,127,48,11,3,32,52,176
Oral Roberts8,8,Chris Miller,SO,F,Oral Roberts,Summit,32,395,84,137,84,137,0,0,21,37,41,35,76,6,8,10,36,92,189
Oral Roberts9,9,Spencer Sutton,FR,G,Oral Roberts,Summit,22,127,10,26,3,7,7,19,1,3,4,4,8,9,2,0,13,15,28
Oral Roberts10,10,Emir Ahmedic,FR,F,Oral Roberts,Summit,18,110,16,40,16,40,0,0,8,14,9,12,21,2,3,2,5,28,40
Oral Roberts11,11,Kellen Manek,FR,F,Oral Roberts,Summit,12,48,6,16,2,6,4,10,13,18,5,8,13,3,1,1,3,4,29
Oral Roberts12,12,James Conley,JR,G,Oral Roberts,Summit,2,23,0,2,0,0,0,2,0,0,0,3,3,6,1,1,3,1,0
Oregon1,1,Payton Pritchard,SO,G,Oregon,Pac-12,34,1194,165,375,84,178,81,197,73,93,18,110,128,160,45,0,71,83,484
Oregon2,2,Troy Brown,FR,F,Oregon,Pac-12,33,1035,138,312,106,204,32,108,73,97,51,155,206,100,52,7,81,71,381
Oregon3,3,Elijah Brown,JR,G,Oregon,Pac-12,34,1001,151,367,63,124,88,243,77,83,26,90,116,84,27,1,60,63,467
Oregon4,4,MiKyle McIntosh,SR,F,Oregon,Pac-12,34,959,141,306,105,205,36,101,75,105,53,159,212,51,27,12,61,111,393
Oregon5,5,Paul White,JR,F,Oregon,Pac-12,31,717,95,205,66,121,29,84,64,77,40,67,107,46,19,14,27,105,283
Oregon6,6,Kenny Wooten,FR,F,Oregon,Pac-12,34,670,88,131,88,130,0,1,36,59,45,107,152,8,20,88,30,93,212
Oregon7,7,Victor Bailey Jr.,FR,G,Oregon,Pac-12,34,545,69,176,44,97,25,79,44,51,21,38,59,30,13,4,26,41,207
Oregon8,8,Keith Smith,SO,F,Oregon,Pac-12,33,304,26,55,26,48,0,7,12,18,21,26,47,20,15,6,15,36,64
Oregon9,9,Abu Kigab,FR,F,Oregon,Pac-12,33,256,20,60,15,38,5,22,9,22,12,23,35,8,13,7,14,39,54
Oregon10,10,Roman Sorkin,SR,F,Oregon,Pac-12,20,140,22,44,13,18,9,26,7,9,8,11,19,5,0,7,5,23,60
Oregon11,11,M.J. Cage,FR,F,Oregon,Pac-12,11,71,8,13,7,12,1,1,2,4,9,15,24,2,0,1,3,7,19
Oregon12,12,Evan Gross,SR,G,Oregon,Pac-12,3,8,1,1,1,1,0,0,0,0,0,0,0,3,1,0,3,2,2
Oregon State1,1,Stephen Thompson Jr.,JR,G,Oregon State,Pac-12,32,1172,187,406,123,222,64,184,67,102,25,75,100,104,55,11,67,72,505
Oregon State2,2,Tres Tinkle,SO,F,Oregon State,Pac-12,32,1164,192,407,144,260,48,147,131,156,56,175,231,117,45,18,93,88,563
Oregon State3,3,Ethan Thompson,FR,G,Oregon State,Pac-12,32,1030,97,253,62,148,35,105,87,119,40,90,130,111,23,12,63,87,316
Oregon State4,4,Drew Eubanks,JR,F,Oregon State,Pac-12,32,1003,164,263,164,263,0,0,94,134,59,159,218,35,15,55,56,87,422
Oregon State5,5,Alfred Hollins,FR,F,Oregon State,Pac-12,31,429,60,123,46,84,14,39,45,68,23,59,82,14,18,9,25,67,179
Oregon State6,6,Seth Berger,SR,F,Oregon State,Pac-12,31,408,38,80,35,65,3,15,13,24,32,40,72,29,18,2,22,58,92
Oregon State7,7,Kendal Manuel,SO,G,Oregon State,Pac-12,29,309,25,62,11,25,14,37,11,18,3,32,35,8,10,2,13,27,75
Oregon State8,8,Gligorije Rakocevic,JR,C,Oregon State,Pac-12,27,285,29,57,29,56,0,1,16,28,23,36,59,7,6,2,19,51,74
Oregon State9,9,Zach Reichle,FR,G,Oregon State,Pac-12,30,262,16,52,4,17,12,35,7,10,12,27,39,16,9,0,22,31,51
Oregon State10,10,Ronnie Stacy,SR,G,Oregon State,Pac-12,20,173,13,38,11,32,2,6,6,19,7,17,24,11,2,1,16,36,34
Oregon State11,11,Jaquori McLaughlin,SO,G,Oregon State,Pac-12,6,156,5,21,5,11,0,10,6,6,2,14,16,22,9,3,14,18,16
Oregon State12,12,Ben Kone,,F,Oregon State,Pac-12,16,77,1,11,1,9,0,2,4,4,5,15,20,0,1,1,4,14,6
Oregon State13,13,Xavier Smith,FR,G,Oregon State,Pac-12,7,17,3,4,3,4,0,0,0,0,0,0,0,1,1,0,3,3,6
Oregon State14,14,Tanner Sanders,JR,G,Oregon State,Pac-12,7,15,0,2,0,0,0,2,0,0,0,2,2,0,0,0,1,3,0
Pacific1,1,Jahlil Tripp,SO,F,Pacific,WCC,32,1122,125,281,108,227,17,54,82,125,78,172,250,145,48,7,93,91,349
Pacific2,2,Roberto Gallinat,JR,G,Pacific,WCC,32,1023,153,349,102,190,51,159,111,144,26,64,90,37,20,7,47,79,468
Pacific3,3,Miles Reynolds,JR,G,Pacific,WCC,32,1003,123,298,100,237,23,61,158,197,11,72,83,89,33,2,62,78,427
Pacific4,4,Jack Williams,JR,F,Pacific,WCC,32,992,99,255,59,137,40,118,34,53,44,146,190,28,10,9,33,63,272
Pacific5,5,Anthony Townes,JR,F,Pacific,WCC,32,681,107,195,107,195,0,0,40,55,59,71,130,11,30,20,35,93,254
Pacific6,6,Namdi Okonkwo,SR,C,Pacific,WCC,32,627,68,103,68,103,0,0,28,42,52,96,148,11,5,80,22,77,164
Pacific7,7,Kendall Small,SO,G,Pacific,WCC,19,516,61,148,59,142,2,6,33,58,8,36,44,52,32,2,39,53,157
Pacific8,8,Lafayette Dorsey,FR,G,Pacific,WCC,24,369,61,136,46,86,15,50,33,39,7,55,62,15,13,1,27,34,170
Pacific9,9,Max Tinsley,JR,G,Pacific,WCC,15,75,6,8,4,5,2,3,2,2,2,4,6,3,4,1,2,10,16
Pacific10,10,Otto Taylor,FR,G,Pacific,WCC,14,42,1,9,0,1,1,8,0,0,3,0,3,4,2,0,0,3,3
Penn State1,1,Lamar Stevens,SO,F,Penn State,Big Ten,34,1121,194,429,169,345,25,84,95,138,52,160,212,58,23,37,75,83,508
Penn State2,2,Tony Carr,SO,G,Penn State,Big Ten,32,1116,218,524,137,348,81,176,121,153,28,124,152,151,25,8,75,61,638
Penn State3,3,Shep Garner,SR,G,Penn State,Big Ten,34,1083,124,281,23,43,101,238,29,35,8,59,67,45,28,3,44,74,378
Penn State4,4,Josh Reaves,JR,G,Penn State,Big Ten,29,891,108,230,78,143,30,87,46,61,52,94,146,93,68,16,39,92,292
Penn State5,5,Mike Watkins,SO,F,Penn State,Big Ten,29,764,146,213,146,212,0,1,58,95,58,199,257,20,28,68,49,70,350
Penn State6,6,Nazeer Bostick,SO,G,Penn State,Big Ten,33,575,52,127,46,100,6,27,43,57,30,46,76,24,22,6,37,51,153
Penn State7,7,Jamari Wheeler,FR,G,Penn State,Big Ten,34,514,30,85,26,59,4,26,12,27,27,40,67,55,47,3,31,57,76
Penn State8,8,Julian Moore,SR,F,Penn State,Big Ten,33,369,23,44,23,44,0,0,12,22,28,30,58,11,5,25,11,42,58
Penn State9,9,Satchel Pierce,JR,F,Penn State,Big Ten,22,168,11,33,11,32,0,1,16,28,16,23,39,3,3,5,18,34,38
Penn State10,10,Deividas Zemgulis,JR,F,Penn State,Big Ten,17,112,6,16,2,3,4,13,2,2,8,6,14,4,2,1,3,8,18
Penn State11,11,John Harrar,FR,F,Penn State,Big Ten,22,99,11,18,11,18,0,0,1,5,12,8,20,0,2,2,4,20,23
Penn State12,12,Trent Buttrick,FR,F,Penn State,Big Ten,8,33,2,9,1,5,1,4,0,2,3,7,10,0,0,1,7,7,5
Penn State13,13,Grant Hazle,SO,F,Penn State,Big Ten,3,3,0,0,0,0,0,0,0,0,0,0,0,0,0,1,0,0,0
Penn State14,14,Taylor Nussbaum,FR,G,Penn State,Big Ten,2,2,0,0,0,0,0,0,0,0,0,0,0,0,0,0,0,0,0
Pennsylvania1,1,Ryan Betley,SO,G,Pennsylvania,Ivy,31,1035,141,333,61,127,80,206,84,110,21,133,154,41,25,13,48,67,446
Pennsylvania2,2,AJ Brodeur,SO,F,Pennsylvania,Ivy,31,955,165,305,146,237,19,68,54,84,56,163,219,81,28,39,73,83,403
Pennsylvania3,3,Darnell Foreman,SR,G,Pennsylvania,Ivy,31,915,107,243,86,165,21,78,88,119,13,125,138,114,35,5,51,60,323
Pennsylvania4,4,Antonio Woods,JR,G,Pennsylvania,Ivy,31,863,83,194,55,110,28,84,46,77,20,95,115,61,19,4,39,61,240
Pennsylvania5,5,Max Rothschild,JR,F,Pennsylvania,Ivy,31,714,98,191,98,191,0,0,52,81,57,127,184,72,24,12,69,87,248
Pennsylvania6,6,Caleb Wood,SR,G,Pennsylvania,Ivy,31,587,108,226,50,74,58,152,36,48,12,49,61,29,11,3,20,48,310
Pennsylvania7,7,Devon Goodman,SO,G,Pennsylvania,Ivy,23,327,36,92,26,54,10,38,14,26,5,28,33,35,15,2,22,33,96
Pennsylvania8,8,Jackson Donahue,JR,G,Pennsylvania,Ivy,21,236,28,72,7,15,21,57,5,12,6,15,21,10,4,0,11,17,82
Pennsylvania9,9,Jake Silpe,,G,Pennsylvania,Ivy,20,157,15,34,8,15,7,19,3,9,4,17,21,14,6,0,2,13,40
Pennsylvania10,10,Jarrod Simmons,FR,F,Pennsylvania,Ivy,24,147,19,42,14,27,5,15,15,19,13,27,40,7,4,6,10,25,58
Pennsylvania11,11,Sam Jones,SR,F,Pennsylvania,Ivy,24,111,16,41,0,1,16,40,1,2,1,20,21,1,2,0,1,10,49
Pennsylvania12,12,Matt MacDonald,SR,G,Pennsylvania,Ivy,19,103,9,14,8,11,1,3,6,13,8,7,15,4,8,1,3,9,25
Pennsylvania13,13,Eddie Scott,FR,G,Pennsylvania,Ivy,9,100,13,25,11,19,2,6,5,16,10,17,27,2,2,0,7,15,33
Pennsylvania14,14,Jakub Mijakowski,,F,Pennsylvania,Ivy,7,39,4,16,1,4,3,12,0,0,2,4,6,1,1,0,1,3,11
Pennsylvania15,15,Dan Dwyer,SR,F,Pennsylvania,Ivy,7,37,2,3,2,3,0,0,0,1,2,5,7,4,1,0,4,7,4
Pennsylvania16,16,Collin McManus,JR,C,Pennsylvania,Ivy,8,21,2,2,2,2,0,0,0,0,2,2,4,2,0,1,0,0,4
Pennsylvania17,17,Ray Jerome,,G,Pennsylvania,Ivy,2,13,1,4,0,1,1,3,2,2,0,2,2,4,2,0,0,1,5
Pennsylvania18,18,Zack Kaminsky,,F,Pennsylvania,Ivy,4,12,0,4,0,1,0,3,1,2,0,1,1,0,0,0,1,0,1
Pepperdine1,1,Colbey Ross,FR,G,Pepperdine,WCC,32,1017,151,325,110,229,41,96,105,128,11,84,95,179,33,5,88,77,448
Pepperdine2,2,Trae Berhow,FR,G,Pepperdine,WCC,30,916,107,235,59,115,48,120,38,51,44,126,170,26,17,3,34,78,300
Pepperdine3,3,Kameron Edwards,SO,F,Pepperdine,WCC,23,672,126,264,114,233,12,31,73,109,38,109,147,25,19,8,45,64,337
Pepperdine4,4,Amadi Udenyi,SR,G,Pepperdine,WCC,28,617,33,116,26,66,7,50,17,28,5,42,47,95,16,1,52,36,90
Pepperdine5,5,Matthew Atewe,SR,F,Pepperdine,WCC,28,561,77,146,77,146,0,0,35,67,61,106,167,10,8,26,38,76,189
Pepperdine6,6,Eric Cooper,,G,Pepperdine,WCC,19,536,84,195,44,83,40,112,42,49,4,30,34,24,9,0,18,29,250
Pepperdine7,7,Darnell Dunn,JR,F,Pepperdine,WCC,32,522,67,156,65,140,2,16,68,86,37,45,82,20,9,8,37,39,204
Pepperdine8,8,Jade' Smith,,G,Pepperdine,WCC,24,399,38,102,37,81,1,21,17,30,17,45,62,29,22,6,21,48,94
Pepperdine9,9,Knox Hellums,SO,G,Pepperdine,WCC,27,386,41,95,13,24,28,71,11,16,5,35,40,16,9,3,6,27,121
Pepperdine10,10,Harrison Meads,JR,F,Pepperdine,WCC,23,300,31,51,31,51,0,0,14,22,18,30,48,1,5,5,11,40,76
Pepperdine11,11,Nolan Taylor,SO,F,Pepperdine,WCC,15,299,52,105,51,97,1,8,28,47,26,34,60,13,3,4,10,36,133
Pepperdine12,12,Kaijae Yee-Stephens,,G,Pepperdine,WCC,10,92,10,25,7,15,3,10,1,3,2,5,7,6,1,0,1,11,24
Pepperdine13,13,Elijah Lee,SO,G,Pepperdine,WCC,11,83,4,11,1,6,3,5,1,6,0,8,8,4,3,0,8,6,12
Pepperdine14,14,Kevin Hempy,SR,F,Pepperdine,WCC,10,47,1,2,1,1,0,1,3,4,0,4,4,1,1,0,2,8,5
Pepperdine15,15,Caleb Martin,SO,G,Pepperdine,WCC,2,3,0,1,0,0,0,1,0,0,0,0,0,0,0,0,1,0,0
Pittsburgh1,1,Marcus Carr,FR,G,Pittsburgh,ACC,32,916,106,268,70,160,36,108,72,88,8,82,90,129,20,4,88,70,320
Pittsburgh2,2,Jared Wilson-Frame,JR,G,Pittsburgh,ACC,32,897,142,379,68,148,74,231,58,70,24,88,112,50,16,4,71,64,416
Pittsburgh3,3,Parker Stewart,FR,G,Pittsburgh,ACC,32,839,90,235,19,51,71,184,40,50,16,89,105,29,14,5,19,51,291
Pittsburgh4,4,Khameron Davis,FR,G,Pittsburgh,ACC,32,769,45,111,22,49,23,62,14,20,8,82,90,31,19,16,36,53,127
Pittsburgh5,5,Shamiel Stevenson,FR,G,Pittsburgh,ACC,32,761,95,188,80,148,15,40,68,112,27,114,141,33,16,8,72,50,273
Pittsburgh6,6,Jonathan Milligan,SR,G,Pittsburgh,ACC,32,562,52,125,42,76,10,49,47,63,4,31,35,47,10,1,40,30,161
Pittsburgh7,7,Terrell Brown,FR,F,Pittsburgh,ACC,31,535,56,134,53,116,3,18,22,35,39,65,104,17,7,46,30,69,137
Pittsburgh8,8,Kene Chukwuka,SO,F,Pittsburgh,ACC,31,528,27,76,18,29,9,47,13,30,27,57,84,26,16,13,28,79,76
Pittsburgh9,9,Ryan Luther,SR,F,Pittsburgh,ACC,10,325,48,105,36,74,12,31,19,29,36,65,101,28,16,7,19,28,127
Pittsburgh10,10,Peace Ilegomah,FR,C,Pittsburgh,ACC,23,133,5,9,5,9,0,0,6,12,7,15,22,3,2,8,11,44,16
Pittsburgh11,11,Monty Boykins,SR,G,Pittsburgh,ACC,20,113,6,31,2,10,4,21,11,22,0,10,10,2,2,0,7,8,27
Pittsburgh12,12,Samson George,FR,F,Pittsburgh,ACC,13,52,5,8,5,8,0,0,1,3,3,9,12,1,0,0,0,6,11
Pittsburgh13,13,Zach Smith,SR,G,Pittsburgh,ACC,8,11,0,3,0,0,0,3,0,0,0,1,1,1,0,0,0,1,0
Pittsburgh14,14,Anthony Starzynski,SO,G,Pittsburgh,ACC,4,5,1,1,0,0,1,1,0,0,0,0,0,0,0,0,1,0,3
Pittsburgh15,15,Joe Mascaro,JR,G,Pittsburgh,ACC,4,4,0,0,0,0,0,0,0,0,0,0,0,1,0,0,0,0,0
Portland1,1,Josh McSwiggan,SO,G,Portland,WCC,32,962,116,275,46,114,70,161,46,54,20,96,116,40,17,7,39,43,348
Portland2,2,Marcus Shaver,,G,Portland,WCC,32,908,135,326,102,202,33,124,91,106,7,98,105,75,32,1,50,72,394
Portland3,3,Philipp Hartwich,SR,C,Portland,WCC,32,826,71,112,71,112,0,0,27,89,60,193,253,40,15,73,44,112,169
Portland4,4,Franklin Porter,SO,G,Portland,WCC,32,825,107,248,77,171,30,77,48,64,12,93,105,60,15,9,58,73,292
Portland5,5,JoJo Walker,FR,G,Portland,WCC,32,811,74,191,41,102,33,89,69,98,6,60,66,78,30,0,63,61,250
Portland6,6,Tahirou Diabate,FR,F,Portland,WCC,30,593,80,142,79,138,1,4,30,57,43,82,125,4,19,24,34,73,191
Portland7,7,Malcolm Porter,FR,G,Portland,WCC,30,592,76,178,60,125,16,53,41,61,5,48,53,59,16,0,45,37,209
Portland8,8,D'Marques Tyson,,G,Portland,WCC,30,565,85,184,22,50,63,134,24,28,6,58,64,16,10,1,24,39,257
Portland9,9,Joseph Smoyer,SO,F,Portland,WCC,23,174,15,27,14,26,1,1,10,15,6,19,25,4,3,10,5,39,41
Portland10,10,Rashad Jackson,JR,G,Portland,WCC,15,118,13,38,8,24,5,14,15,19,2,8,10,5,7,1,8,18,46
Portland11,11,Austin Stone,JR,F,Portland,WCC,9,48,5,13,4,11,1,2,3,4,3,12,15,2,1,1,0,5,14
Portland12,12,Brian Smith,FR,G,Portland,WCC,6,28,4,11,2,5,2,6,0,1,0,2,2,4,0,0,2,4,10
Portland State1,1,Bryce Canda,SR,G,Portland State,Big Sky,33,1134,171,425,96,193,75,232,44,67,46,151,197,82,55,6,51,34,461
Portland State2,2,Holland Woods,FR,G,Portland State,Big Sky,33,1060,105,257,78,168,27,89,117,148,17,72,89,186,50,4,86,70,354
Portland State3,3,Brandon Hollins,SR,F,Portland State,Big Sky,29,739,115,205,111,185,4,20,52,75,76,145,221,21,29,5,32,84,286
Portland State4,4,Michael Mayhew,JR,G,Portland State,Big Sky,33,665,87,219,23,53,64,166,33,41,28,51,79,51,40,0,43,69,271
Portland State5,5,Deante Strickland,JR,G,Portland State,Big Sky,33,661,85,205,33,80,52,125,22,37,20,52,72,86,33,1,40,57,244
Portland State6,6,Deontae North,SR,G,Portland State,Big Sky,19,572,135,293,93,171,42,122,88,123,41,52,93,46,34,5,37,56,400
Portland State7,7,Ryan Edwards,SR,C,Portland State,Big Sky,32,562,122,256,112,225,10,31,49,74,58,68,126,17,11,55,48,108,303
Portland State8,8,Jamie Orme,JR,F,Portland State,Big Sky,30,387,41,106,31,75,10,31,28,47,37,55,92,9,28,19,21,82,120
Portland State9,9,Traylin Farris,SR,C,Portland State,Big Sky,22,326,51,101,50,100,1,1,30,50,35,41,76,14,18,14,11,62,133
Portland State10,10,Derek Brown,,G,Portland State,Big Sky,18,204,34,64,30,50,4,14,19,30,12,19,31,20,11,1,21,43,91
Portland State11,11,Braxton Tucker,,F,Portland State,Big Sky,17,189,33,68,33,64,0,4,20,26,16,13,29,2,5,1,9,35,86
Portland State12,12,Devyn Wilson,JR,G,Portland State,Big Sky,14,88,8,32,5,10,3,22,3,3,7,7,14,4,5,0,9,16,22
Portland State13,13,Brendan Rumel,SO,F,Portland State,Big Sky,8,59,14,24,14,23,0,1,10,12,11,7,18,0,4,3,4,10,38
Portland State14,14,Vonte Carter,JR,G,Portland State,Big Sky,8,28,10,18,7,12,3,6,1,2,0,5,5,0,4,1,2,3,24
Prairie View1,1,Gary Blackston,JR,G,Prairie View,SWAC,33,1065,217,494,173,371,44,123,156,217,48,128,176,116,51,3,100,110,634
Prairie View2,2,JD Wallace,SR,C,Prairie View,SWAC,34,1055,108,157,108,155,0,2,48,86,104,186,290,10,31,39,34,90,264
Prairie View3,3,Dennis Jones,JR,G,Prairie View,SWAC,33,1053,134,335,102,223,32,112,111,180,19,46,65,172,62,1,121,96,411
Prairie View4,4,Zachary Hamilton,SR,F,Prairie View,SWAC,34,938,181,453,92,215,89,238,89,113,35,110,145,43,32,9,57,94,540
Prairie View5,5,Troy Thompson,SR,G,Prairie View,SWAC,31,563,68,187,23,55,45,132,31,43,25,39,64,24,18,8,31,38,212
Prairie View6,6,Iwin Ellis,JR,F,Prairie View,SWAC,34,550,39,55,39,55,0,0,10,25,33,62,95,10,15,10,18,73,88
Prairie View7,7,Shaq Preston,,G,Prairie View,SWAC,30,528,59,132,53,103,6,29,33,50,23,52,75,21,20,8,26,71,157
Prairie View8,8,Austin Starr,JR,G,Prairie View,SWAC,33,486,36,126,6,24,30,102,26,32,15,29,44,28,15,0,22,62,128
Prairie View9,9,Shay'rone Jett,,F,Prairie View,SWAC,21,193,18,44,17,34,1,10,6,11,13,18,31,4,3,6,11,37,43
Prairie View10,10,Keion Alexander,SR,F,Prairie View,SWAC,30,181,15,29,15,29,0,0,8,19,20,22,42,3,4,17,10,34,38
Prairie View11,11,Juan Hood,FR,G,Prairie View,SWAC,26,84,8,17,8,14,0,3,9,10,2,7,9,8,1,0,3,10,25
Prairie View12,12,Isaih Hood,FR,F,Prairie View,SWAC,8,73,2,4,2,3,0,1,5,7,1,8,9,0,3,1,5,16,9
Prairie View13,13,Jordan Lumpkins,SR,F,Prairie View,SWAC,17,70,2,6,2,6,0,0,0,0,1,8,9,0,2,1,6,15,4
Prairie View14,14,Xavier Eaglin,,F,Prairie View,SWAC,6,11,3,4,3,4,0,0,0,0,1,3,4,0,0,0,0,2,6
Presbyterian1,1,Reggie Dillard,SR,G,Presbyterian,Big South,32,1071,175,401,108,209,67,192,81,112,17,86,103,56,23,9,84,72,498
Presbyterian2,2,Davon Bell,SR,G,Presbyterian,Big South,32,1062,134,317,108,237,26,80,112,139,13,89,102,165,50,7,69,64,406
Presbyterian3,3,JC Younger,SO,G,Presbyterian,Big South,32,945,112,284,45,110,67,174,38,45,22,100,122,36,12,1,46,38,329
Presbyterian4,4,Romeo Crouch,FR,G,Presbyterian,Big South,32,763,60,144,29,64,31,80,22,39,44,76,120,36,32,2,47,34,173
Presbyterian5,5,Armel TeTe,SO,C,Presbyterian,Big South,32,684,48,108,48,108,0,0,30,53,51,94,145,4,14,30,31,82,126
Presbyterian6,6,Jaron Withers,SR,G,Presbyterian,Big South,31,522,26,70,24,62,2,8,20,36,21,56,77,26,12,1,33,60,74
Presbyterian7,7,Ruben Arroyo-Felix,SR,F,Presbyterian,Big South,29,474,52,95,45,71,7,24,13,34,33,51,84,10,6,10,17,33,124
Presbyterian8,8,Ethan Kay,JR,G,Presbyterian,Big South,31,348,50,145,3,8,47,137,4,5,5,26,31,9,16,0,4,7,151
Presbyterian9,9,Francois Lewis,JR,F,Presbyterian,Big South,16,335,74,145,50,86,24,59,27,40,19,57,76,16,9,2,18,48,199
Presbyterian10,10,Montenia Nelson,JR,G,Presbyterian,Big South,6,93,11,24,7,13,4,11,2,5,1,9,10,6,0,0,9,8,28
Presbyterian11,11,Maleek Catchings,,G,Presbyterian,Big South,10,56,4,11,3,8,1,3,0,0,5,6,11,0,1,0,1,7,9
Presbyterian12,12,Stephen Osu,SR,C,Presbyterian,Big South,9,32,3,6,3,6,0,0,0,0,9,5,14,0,0,0,3,4,6
Presbyterian13,13,Jamie Baker,,G,Presbyterian,Big South,3,19,0,5,0,3,0,2,1,2,1,4,5,4,0,0,1,0,1
Presbyterian14,14,Brent Carraway,,G,Presbyterian,Big South,2,10,0,4,0,3,0,1,0,0,0,0,0,0,0,0,0,2,0
Presbyterian15,15,Jo'Vontae Millner,,G,Presbyterian,Big South,2,7,0,1,0,0,0,1,0,0,1,0,1,0,0,0,2,1,0
Princeton1,1,Devin Cannady,JR,G,Princeton,Ivy,29,1064,164,362,84,159,80,203,76,86,17,140,157,49,24,2,44,54,484
Princeton2,2,Amir Bell,SR,G,Princeton,Ivy,29,1001,112,252,80,165,32,87,60,92,24,132,156,107,40,19,43,91,316
Princeton3,3,Myles Stephens,JR,G,Princeton,Ivy,29,998,171,329,131,232,40,97,63,92,40,142,182,41,13,26,64,61,445
Princeton4,4,Sebastian Much,FR,F,Princeton,Ivy,27,528,73,162,38,67,35,95,11,22,24,50,74,36,9,7,45,49,192
Princeton5,5,Aaron Young,SR,G,Princeton,Ivy,28,486,38,97,9,19,29,78,13,13,3,22,25,30,10,0,14,45,118
Princeton6,6,Jerome Desrosiers,FR,F,Princeton,Ivy,27,416,56,126,19,37,37,89,19,25,21,52,73,26,6,1,19,27,168
Princeton7,7,Ryan Schwieger,FR,G,Princeton,Ivy,27,344,28,71,23,48,5,23,15,22,11,35,46,12,13,4,26,33,76
Princeton8,8,Mike LeBlanc,SR,F,Princeton,Ivy,24,268,13,49,4,11,9,38,8,10,8,31,39,13,6,3,12,27,43
Princeton9,9,Richmond Aririguzoh,SO,C,Princeton,Ivy,27,247,31,52,31,52,0,0,12,29,19,26,45,20,1,14,24,30,74
Princeton10,10,Alec Brennan,SR,F,Princeton,Ivy,26,212,21,44,12,25,9,19,6,12,8,11,19,9,2,8,10,31,57
Princeton11,11,Will Gladson,SO,F,Princeton,Ivy,15,157,22,48,17,35,5,13,5,6,5,15,20,11,5,3,8,20,54
Princeton12,12,Jose Morales,SO,G,Princeton,Ivy,12,88,7,20,5,12,2,8,11,12,2,5,7,6,5,2,6,14,27
Princeton13,13,Noah Bramlage,JR,F,Princeton,Ivy,13,56,5,15,4,11,1,4,1,3,1,8,9,5,1,0,1,6,12
Princeton14,14,Elijah Barnes,,F,Princeton,Ivy,9,55,5,16,3,9,2,7,4,7,4,14,18,1,0,0,4,6,16
Princeton15,15,Vittorio Reynoso-Avila,SO,F,Princeton,Ivy,9,38,5,9,5,9,0,0,7,10,3,3,6,0,0,0,3,6,17
Princeton16,16,Charlie Bagin,FR,G,Princeton,Ivy,10,28,1,6,1,2,0,4,2,2,0,1,1,1,2,1,2,3,4
Princeton17,17,Elias Berbari,JR,G,Princeton,Ivy,9,14,1,2,0,0,1,2,0,0,0,0,0,0,0,0,0,1,3
Providence1,1,Rodney Bullock,SR,F,Providence,Big East,33,1083,156,362,112,228,44,134,107,146,50,143,193,38,26,33,66,82,463
Providence2,2,Jalen Lindsey,SR,G,Providence,Big East,32,1051,90,219,19,39,71,180,34,45,35,80,115,28,31,21,22,65,285
Providence3,3,Kyron Cartwright,SR,G,Providence,Big East,33,1021,133,311,95,212,38,99,86,112,11,85,96,187,42,1,89,62,390
Providence4,4,Alpha Diallo,SO,G,Providence,Big East,31,946,152,324,138,259,14,65,84,115,68,136,204,69,31,9,60,90,402
Providence5,5,Isaiah Jackson,JR,G,Providence,Big East,34,696,76,202,49,128,27,74,79,101,33,114,147,38,25,6,38,60,258
Providence6,6,Kalif Young,SO,F,Providence,Big East,34,564,59,110,59,110,0,0,30,61,49,90,139,20,13,21,30,67,148
Providence7,7,Nate Watson,FR,C,Providence,Big East,34,466,89,147,89,147,0,0,54,77,29,38,67,4,7,26,29,68,232
Providence8,8,Makai Ashton-Langford,FR,G,Providence,Big East,31,406,47,124,44,99,3,25,33,63,4,47,51,52,20,5,43,44,130
Providence9,9,Drew Edwards,SO,G,Providence,Big East,32,332,22,66,18,40,4,26,19,23,14,35,49,14,16,2,17,37,67
Providence10,10,Maliek White,SO,G,Providence,Big East,24,323,42,95,26,48,16,47,19,31,4,22,26,18,17,3,18,20,119
Providence11,11,Tom Planek,SR,F,Providence,Big East,11,19,2,7,2,7,0,0,0,1,1,2,3,0,4,0,2,4,4
Providence12,12,Dajour Dickens,FR,C,Providence,Big East,3,10,3,5,3,5,0,0,0,0,0,3,3,0,0,1,0,1,6
Providence13,13,Andrew Fonts,FR,G,Providence,Big East,7,8,1,3,1,2,0,1,0,0,0,0,0,0,1,0,0,1,2
Purdue1,1,Dakota Mathias,SR,G,Purdue,Big Ten,34,1064,144,298,54,104,90,194,45,55,5,133,138,139,43,9,49,58,423
Purdue2,2,Vince Edwards,SR,F,Purdue,Big Ten,32,1011,162,344,115,224,47,120,93,111,66,169,235,96,16,19,59,56,464
Purdue3,3,Carsen Edwards,SO,G,Purdue,Big Ten,34,1004,210,451,121,235,89,216,119,147,13,121,134,102,40,8,60,57,628
Purdue4,4,P.J. Thompson,SR,G,Purdue,Big Ten,34,941,68,155,15,34,53,121,52,61,13,46,59,58,40,2,30,63,241
Purdue5,5,Isaac Haas,SR,C,Purdue,Big Ten,34,803,182,293,182,293,0,0,141,185,56,135,191,26,5,46,54,81,505
Purdue6,6,Ryan Cline,JR,G,Purdue,Big Ten,34,589,48,120,10,25,38,95,1,2,3,58,61,60,13,2,18,33,135
Purdue7,7,Matt Haarms,FR,F,Purdue,Big Ten,34,561,68,113,67,106,1,7,27,49,30,75,105,19,11,73,27,84,164
Purdue8,8,Nojel Eastern,FR,G,Purdue,Big Ten,34,434,39,80,36,71,3,9,20,47,35,52,87,38,20,5,37,53,101
Purdue9,9,Grady Eifert,JR,F,Purdue,Big Ten,33,270,19,31,17,26,2,5,12,21,16,38,54,19,4,1,8,21,52
Purdue10,10,Jacquil Taylor,JR,F,Purdue,Big Ten,15,88,11,26,9,21,2,5,3,6,5,17,22,3,4,6,7,10,27
Purdue11,11,Tommy Luce,SO,G,Purdue,Big Ten,12,33,3,8,3,7,0,1,3,8,2,1,3,8,2,0,7,6,9
Purdue12,12,Eden Ewing,JR,F,Purdue,Big Ten,6,27,4,9,3,6,1,3,1,4,0,3,3,0,0,0,1,6,10
Quinnipiac1,1,Rich Kelly,FR,G,Quinnipiac,MAAC,33,1128,122,313,71,152,51,161,72,94,10,65,75,155,23,4,97,64,367
Quinnipiac2,2,Cameron Young,SR,G,Quinnipiac,MAAC,33,1124,187,442,123,231,64,211,184,244,61,165,226,91,43,10,93,85,622
Quinnipiac3,3,Isaiah Washington,SR,G,Quinnipiac,MAAC,33,1094,86,264,38,107,48,157,53,78,27,86,113,65,30,10,61,89,273
Quinnipiac4,4,Jacob Rigoni,FR,G,Quinnipiac,MAAC,33,857,107,233,32,68,75,165,33,42,22,104,126,35,19,9,43,55,322
Quinnipiac5,5,Abdulai Bundu,JR,F,Quinnipiac,MAAC,33,672,61,111,61,111,0,0,48,72,75,116,191,14,10,20,34,66,170
Quinnipiac6,6,Chaise Daniels,SR,F,Quinnipiac,MAAC,30,633,122,231,122,231,0,0,80,121,39,80,119,14,11,30,67,95,324
Quinnipiac7,7,Aaron Robinson,JR,G,Quinnipiac,MAAC,30,467,34,82,10,14,24,68,1,6,15,58,73,14,14,1,8,35,93
Quinnipiac8,8,Andrew Robinson,JR,G,Quinnipiac,MAAC,22,424,42,120,5,13,37,107,8,13,7,44,51,7,4,0,9,20,129
Quinnipiac9,9,Alain Chigha,SR,F,Quinnipiac,MAAC,29,370,23,61,19,39,4,22,8,17,20,31,51,9,28,2,17,57,58
Quinnipiac10,10,Greg Tarca,,G,Quinnipiac,MAAC,4,5,3,7,3,5,0,2,0,3,1,0,1,0,0,0,0,0,6
Quinnipiac11,11,Matt Donahue,,G,Quinnipiac,MAAC,1,1,0,0,0,0,0,0,0,0,0,0,0,0,0,0,0,0,0
Radford1,1,"Ed Polite, Jr.",JR,F,Radford,Big South,34,1087,160,330,138,253,22,77,118,164,72,191,263,47,66,32,64,77,460
Radford2,2,Carlik Jones,FR,G,Radford,Big South,34,1023,135,323,99,210,36,113,94,122,18,109,127,102,37,8,56,54,400
Radford3,3,Donald Hicks,SO,G,Radford,Big South,34,922,91,250,31,101,60,149,23,26,42,73,115,46,16,0,37,74,265
Radford4,4,Randy Phillips,SR,C,Radford,Big South,34,777,90,163,90,163,0,0,56,93,100,94,194,25,17,33,56,85,236
Radford5,5,Christian Bradford,SR,G,Radford,Big South,34,748,48,140,24,57,24,83,22,28,9,51,60,66,20,2,35,39,142
Radford6,6,Travis Fields,SO,G,Radford,Big South,33,662,72,189,45,109,27,80,29,37,15,56,71,74,33,4,45,44,200
Radford7,7,Devonnte Holland,SO,F,Radford,Big South,34,506,66,128,66,127,0,1,32,51,52,64,116,12,7,14,45,86,164
Radford8,8,Caleb Tanner,JR,G,Radford,Big South,34,453,65,158,6,21,59,137,31,32,2,13,15,15,6,0,8,29,220
Radford9,9,Justin Cousin,SR,G,Radford,Big South,33,351,26,92,3,18,23,74,6,8,4,23,27,12,3,1,14,29,81
Radford10,10,Leroy Butts IV,FR,F,Radford,Big South,32,245,31,61,25,43,6,18,6,15,16,38,54,7,8,1,14,16,74
Radford11,11,Darius Bolstad,JR,C,Radford,Big South,13,58,10,17,10,17,0,0,3,5,6,8,14,1,0,5,6,17,23
Radford12,12,Tristan Owens,JR,F,Radford,Big South,15,56,4,20,2,7,2,13,1,2,2,7,9,5,1,0,5,5,11
Radford13,13,Devin Cooper,SO,G,Radford,Big South,6,22,2,8,0,4,2,4,0,0,0,3,3,2,0,0,1,1,6
Radford14,14,Anias Saunders,FR,G,Radford,Big South,10,15,2,3,0,0,2,3,2,2,1,2,3,1,0,0,2,0,8
Rhode Island1,1,Jared Terrell,SR,G,Rhode Island,A-10,31,1029,182,415,112,247,70,168,110,134,32,74,106,74,48,6,57,67,544
Rhode Island2,2,Jeff Dowtin,SO,G,Rhode Island,A-10,31,1013,109,243,86,188,23,55,59,83,22,76,98,174,31,15,38,51,300
Rhode Island3,3,Stanford Robinson,SR,G,Rhode Island,A-10,30,826,107,229,86,161,21,68,43,69,51,120,171,57,67,15,50,84,278
Rhode Island4,4,E.C. Matthews,SR,G,Rhode Island,A-10,25,698,116,273,84,163,32,110,57,75,19,77,96,22,21,13,43,39,321
Rhode Island5,5,Jarvis Garrett,SR,G,Rhode Island,A-10,31,643,60,144,34,77,26,67,23,33,21,49,70,73,22,0,30,56,169
Rhode Island6,6,Fatts Russell,,G,Rhode Island,A-10,31,564,75,214,41,96,34,118,31,38,15,40,55,47,24,1,24,61,215
Rhode Island7,7,Andre Berry,SR,F,Rhode Island,A-10,31,545,118,187,118,187,0,0,45,62,44,80,124,11,2,9,39,71,281
Rhode Island8,8,Cyril Langevine,SO,F,Rhode Island,A-10,28,483,64,99,64,99,0,0,39,74,63,97,160,8,9,32,25,83,167
Rhode Island9,9,Nicola Akele,JR,F,Rhode Island,A-10,28,246,26,56,24,48,2,8,4,6,24,30,54,5,7,5,5,48,58
Rhode Island10,10,Ryan Preston,JR,F,Rhode Island,A-10,17,92,10,22,10,20,0,2,1,4,11,18,29,3,4,8,5,23,21
Rhode Island11,11,Mike Layssard,SO,F,Rhode Island,A-10,12,36,9,13,9,13,0,0,1,2,2,8,10,1,0,1,2,6,19
Rhode Island12,12,Eric Dadika,SO,G,Rhode Island,A-10,12,24,3,8,1,4,2,4,0,0,0,1,1,0,1,0,2,2,8
Rhode Island13,13,Michael Tertsea,SO,C,Rhode Island,A-10,8,14,0,1,0,1,0,0,0,0,1,1,2,0,0,2,1,2,0
Rhode Island14,14,Will Leviton,JR,G,Rhode Island,A-10,8,11,0,1,0,1,0,0,0,0,1,1,2,2,1,0,1,0,0
Rice1,1,Connor Cashaw,JR,G,Rice,CUSA,30,1010,158,397,107,237,51,160,98,135,42,172,214,96,40,2,65,60,465
Rice2,2,Bishop Mency,SR,G,Rice,CUSA,31,973,77,214,24,40,53,174,36,56,49,105,154,26,16,7,32,57,243
Rice3,3,Ako Adams,SO,G,Rice,CUSA,31,921,98,271,44,111,54,160,74,92,9,72,81,100,24,1,82,66,324
Rice4,4,Malik Osborne,FR,F,Rice,CUSA,31,840,92,222,70,139,22,83,74,116,71,131,202,26,19,24,57,69,280
Rice5,5,Robert Martin,SO,F,Rice,CUSA,31,618,61,143,51,106,10,37,53,82,25,68,93,28,17,2,52,56,185
Rice6,6,Najja Hunter,FR,G,Rice,CUSA,30,529,71,164,58,122,13,42,36,60,36,56,92,33,18,9,48,40,191
Rice7,7,Miles Lester,FR,G,Rice,CUSA,29,361,25,78,5,25,20,53,20,27,4,32,36,46,8,0,32,18,90
Rice8,8,Tim Harrison,SO,F,Rice,CUSA,31,329,37,96,24,45,13,51,10,19,18,47,65,5,5,6,26,42,97
Rice9,9,Austin Meyer,SO,F,Rice,CUSA,22,259,40,54,40,54,0,0,17,32,16,33,49,3,3,13,27,50,97
Rice10,10,A.J. Lapray,SR,G,Rice,CUSA,10,211,31,75,7,19,24,56,5,5,4,29,33,8,10,0,15,18,91
Rice11,11,Dylan Jones,SR,F,Rice,CUSA,23,185,21,33,21,33,0,0,9,22,13,14,27,6,5,2,15,30,51
Rice12,12,J.T. Trauber,SR,G,Rice,CUSA,4,8,0,3,0,1,0,2,0,0,0,1,1,1,0,0,0,2,0
Rice13,13,Addison Owen,,G,Rice,CUSA,2,4,0,0,0,0,0,0,0,0,0,2,2,0,1,0,0,1,0
Rice14,14,Grant Youngkin,,G,Rice,CUSA,1,2,0,1,0,1,0,0,0,0,0,0,0,0,0,0,0,0,0
Richmond1,1,Jacob Gilyard,FR,G,Richmond,A-10,32,1166,126,280,68,129,58,151,56,67,15,54,69,130,89,1,54,56,366
Richmond2,2,Nick Sherod,SO,G,Richmond,A-10,32,1008,165,343,104,187,61,156,65,81,31,128,159,45,31,4,36,58,456
Richmond3,3,Grant Golden,FR,F,Richmond,A-10,32,981,208,418,186,338,22,80,60,96,49,166,215,69,19,39,82,79,498
Richmond4,4,De'Monte Buckingham,,G,Richmond,A-10,30,951,120,274,85,166,35,108,91,117,49,161,210,103,31,11,80,72,366
Richmond5,5,Khwan Fore,JR,G,Richmond,A-10,29,931,117,244,106,204,11,40,74,113,23,69,92,77,27,4,44,64,319
Richmond6,6,Julius Johnson,JR,G,Richmond,A-10,32,510,39,99,15,29,24,70,15,19,10,43,53,26,17,1,16,58,117
Richmond7,7,Nathan Cayo,FR,G,Richmond,A-10,32,405,29,66,29,56,0,10,16,27,20,35,55,12,11,12,17,58,74
Richmond8,8,Solly Stansbury,JR,F,Richmond,A-10,17,214,20,56,16,34,4,22,8,13,11,17,28,12,12,2,12,30,52
Richmond9,9,Joe Kirby,SR,G,Richmond,A-10,27,167,11,34,6,12,5,22,0,1,5,12,17,9,7,0,4,13,27
Richmond10,10,Paul Friendshuh,JR,F,Richmond,A-10,22,84,4,8,3,7,1,1,3,8,4,4,8,2,0,1,10,18,12
Richmond11,11,Jordan Madrid-Andrews,SR,F,Richmond,A-10,13,43,2,7,2,4,0,3,0,0,1,4,5,0,0,2,4,8,4
Richmond12,12,Keith Oddo,,G,Richmond,A-10,5,14,2,2,1,1,1,1,1,2,0,0,0,1,0,0,0,4,6
Richmond13,13,Sullivan Kulju,,F,Richmond,A-10,1,1,0,0,0,0,0,0,0,0,0,0,0,0,0,0,0,0,0
Rider1,1,Stevie Jordan,SO,G,Rider,MAAC,30,977,138,306,115,225,23,81,82,124,28,86,114,176,50,10,88,68,381
Rider2,2,Jordan Allen,FR,G,Rider,MAAC,31,879,136,358,47,129,89,229,54,65,24,86,110,20,26,12,43,55,415
Rider3,3,Anthony Durham,JR,G,Rider,MAAC,31,832,77,167,56,103,21,64,46,58,31,80,111,88,29,5,36,69,221
Rider4,4,Dimencio Vaughn,FR,G,Rider,MAAC,28,765,153,302,127,229,26,73,111,145,69,118,187,29,51,18,69,82,443
Rider5,5,Frederick Scott,FR,F,Rider,MAAC,31,734,143,276,113,195,30,81,77,174,65,139,204,23,17,9,54,70,393
Rider6,6,Tyere Marshall,SO,C,Rider,MAAC,31,702,126,249,126,248,0,1,60,111,76,128,204,32,16,16,39,83,312
Rider7,7,Kealen Washington-Ives,JR,G,Rider,MAAC,31,440,35,94,19,43,16,51,12,23,8,27,35,46,14,0,28,50,98
Rider8,8,Devine Eke,SO,F,Rider,MAAC,30,284,25,35,22,31,3,4,11,41,26,32,58,15,10,24,8,47,64
Rider9,9,Tyrei Randall,FR,G,Rider,MAAC,31,240,29,67,9,21,20,46,18,26,4,31,35,5,11,8,12,28,96
Rider10,10,Karamoko Cisse,JR,F,Rider,MAAC,30,240,23,41,23,41,0,0,23,49,26,33,59,3,8,3,15,48,69
Rider11,11,Paxton Wilson,FR,G,Rider,MAAC,23,121,10,24,2,3,8,21,8,10,3,9,12,5,3,0,4,11,36
Rider12,12,Joe Ajike,SR,G,Rider,MAAC,7,11,2,9,1,4,1,5,1,2,1,3,4,0,0,0,3,1,6
Robert Morris1,1,Dachon Burke,SO,G,Robert Morris,NEC,32,1044,210,458,166,328,44,130,98,156,59,125,184,80,67,16,86,81,562
Robert Morris2,2,Jon Williams,FR,G,Robert Morris,NEC,33,1044,71,182,13,48,58,134,21,28,5,67,72,114,19,0,84,90,221
Robert Morris3,3,Matty McConnell,JR,G,Robert Morris,NEC,32,1021,104,298,50,115,54,183,82,103,15,125,140,89,64,16,53,76,344
Robert Morris4,4,Koby Thomas,FR,F,Robert Morris,NEC,33,885,145,330,126,251,19,79,86,134,72,155,227,20,20,6,63,58,395
Robert Morris5,5,Leondre Washington,FR,G,Robert Morris,NEC,24,569,57,169,32,89,25,80,65,87,11,38,49,51,22,0,47,45,204
Robert Morris6,6,Charles Bain,FR,F,Robert Morris,NEC,33,564,62,166,37,92,25,74,25,40,46,51,97,9,17,5,56,65,174
Robert Morris7,7,Chris Coalmon,FR,F,Robert Morris,NEC,33,496,43,99,28,54,15,45,10,16,18,30,48,11,10,7,24,65,111
Robert Morris8,8,Ronnie Gombe,SR,F,Robert Morris,NEC,27,362,44,90,44,90,0,0,8,25,45,53,98,0,17,22,27,57,96
Robert Morris9,9,David Cole,FR,F,Robert Morris,NEC,32,342,25,59,25,59,0,0,23,37,26,26,52,3,7,4,21,77,73
Robert Morris10,10,Malik Petteway,JR,F,Robert Morris,NEC,13,247,28,65,28,64,0,1,24,37,33,48,81,2,11,14,14,40,80
Robert Morris11,11,Seth Rouse,,F,Robert Morris,NEC,6,27,3,8,1,6,2,2,0,0,4,3,7,0,1,0,0,4,8
Robert Morris12,12,Taevon Ashmeade,JR,G,Robert Morris,NEC,3,20,2,6,2,5,0,1,0,0,0,1,1,3,1,0,1,3,4
Robert Morris13,13,Nick Castelveter,,G,Robert Morris,NEC,2,4,0,2,0,2,0,0,0,0,1,1,2,0,0,0,0,1,0
Rutgers1,1,Corey Sanders,JR,G,Rutgers,Big Ten,34,1127,205,511,183,413,22,98,85,120,18,129,147,106,44,9,76,54,517
Rutgers2,2,Geo Baker,FR,G,Rutgers,Big Ten,33,1044,127,334,74,187,53,147,51,65,12,61,73,85,35,14,57,69,358
Rutgers3,3,Issa Thiam,SO,G,Rutgers,Big Ten,34,986,88,206,44,85,44,121,17,24,34,114,148,21,24,8,28,63,237
Rutgers4,4,DeShawn Freeman,SR,F,Rutgers,Big Ten,33,839,134,333,129,301,5,32,93,130,81,160,241,29,51,24,63,76,366
Rutgers5,5,Eugene Omoruyi,SO,F,Rutgers,Big Ten,32,694,97,205,97,200,0,5,59,109,70,90,160,31,28,24,44,69,253
Rutgers6,6,Mike Williams,SR,G,Rutgers,Big Ten,25,583,73,187,57,113,16,74,45,58,43,59,102,22,21,14,30,39,207
Rutgers7,7,Mamadou Doucoure,FR,F,Rutgers,Big Ten,34,444,38,105,38,105,0,0,20,33,43,66,109,4,10,10,24,81,96
Rutgers8,8,Candido Sa,SR,F,Rutgers,Big Ten,32,394,26,60,24,55,2,5,10,23,37,64,101,3,12,13,22,43,64
Rutgers9,9,Shaquille Doorson,JR,C,Rutgers,Big Ten,30,362,20,32,20,32,0,0,15,32,40,46,86,10,4,18,12,41,55
Rutgers10,10,Souf Mensah,JR,G,Rutgers,Big Ten,27,181,6,22,6,22,0,0,5,19,7,15,22,13,4,1,17,27,17
Rutgers11,11,Jake Dadika,SR,G,Rutgers,Big Ten,17,105,5,15,3,7,2,8,3,8,0,6,6,5,2,0,2,6,15
Rutgers12,12,Matt Bullock,,F,Rutgers,Big Ten,9,72,9,23,9,17,0,6,4,10,7,8,15,2,1,0,5,8,22
Rutgers13,13,Luke Nathan,FR,F,Rutgers,Big Ten,8,17,1,5,1,4,0,1,2,4,3,4,7,0,0,1,2,3,4
Rutgers14,14,Joey Downes,SO,G,Rutgers,Big Ten,5,16,1,4,0,0,1,4,0,0,0,1,1,1,3,0,0,0,3
Rutgers15,15,Aaren Smith,SO,F,Rutgers,Big Ten,5,11,0,1,0,1,0,0,0,0,2,2,4,1,1,0,2,4,0
Sacramento State1,1,Justin Strings,SR,F,Sacramento State,Big Sky,32,1157,223,522,193,416,30,106,97,157,46,179,225,75,19,30,73,77,573
Sacramento State2,2,Izayah Mauriohooho-Le'afa,,G,Sacramento State,Big Sky,30,931,91,226,43,108,48,118,26,36,7,94,101,107,34,4,54,58,256
Sacramento State3,3,Bryce Fowler,FR,F,Sacramento State,Big Sky,32,884,84,159,68,119,16,40,18,31,35,91,126,64,21,12,51,62,202
Sacramento State4,4,Joshua Patton,SO,F,Sacramento State,Big Sky,32,785,124,203,124,203,0,0,100,142,61,103,164,18,16,58,53,118,348
Sacramento State5,5,Jordan Tolbert,JR,G,Sacramento State,Big Sky,32,781,116,285,67,163,49,122,41,50,14,73,87,73,37,0,61,69,322
Sacramento State6,6,Jeff Wu,JR,G,Sacramento State,Big Sky,25,594,55,133,33,70,22,63,9,11,4,41,45,44,17,1,26,36,141
Sacramento State7,7,Kevin Hicks,JR,G,Sacramento State,Big Sky,31,525,47,140,18,37,29,103,22,25,10,34,44,17,8,0,11,38,145
Sacramento State8,8,Calvin Martin,JR,F,Sacramento State,Big Sky,28,330,27,56,27,56,0,0,21,34,35,46,81,3,12,4,19,72,75
Sacramento State9,9,Chibueze Jacobs,SO,F,Sacramento State,Big Sky,27,206,14,28,11,23,3,5,12,14,13,23,36,6,2,0,15,18,43
Sacramento State10,10,James Herrick,SR,C,Sacramento State,Big Sky,24,110,10,24,10,24,0,0,9,19,6,22,28,1,1,1,5,24,29
Sacramento State11,11,Jamion Wright,FR,G,Sacramento State,Big Sky,12,61,3,11,0,1,3,10,0,0,1,2,3,1,2,0,6,6,9
Sacramento State12,12,Jiday Ugbaja,,G,Sacramento State,Big Sky,6,48,5,12,4,11,1,1,0,0,1,8,9,11,2,0,5,8,11
Sacramento State13,13,Cristian Perez,JR,F,Sacramento State,Big Sky,3,13,1,3,0,1,1,2,0,0,0,1,1,0,1,0,3,0,3
Sacred Heart1,1,Sean Hoehn,JR,G,Sacred Heart,NEC,30,1003,132,333,83,176,49,157,80,101,20,89,109,126,42,4,78,74,393
Sacred Heart2,2,Kinnon LaRose,SO,G,Sacred Heart,NEC,31,861,104,245,45,75,59,170,20,27,37,80,117,26,12,10,30,69,287
Sacred Heart3,3,Mario Matasovic,SR,F,Sacred Heart,NEC,31,853,142,256,120,190,22,66,53,72,67,128,195,41,18,15,72,88,359
Sacred Heart4,4,Joseph Lopez,FR,F,Sacred Heart,NEC,30,802,157,326,156,307,1,19,49,109,104,171,275,27,19,13,64,78,364
Sacred Heart5,5,Charles Tucker Jr.,,G,Sacred Heart,NEC,30,646,35,99,28,68,7,31,29,48,1,50,51,94,15,0,59,59,106
Sacred Heart6,6,Zach Radz,SO,G,Sacred Heart,NEC,21,478,47,132,28,67,19,65,31,39,10,72,82,22,6,2,24,26,144
Sacred Heart7,7,DeVon Barnett,,F,Sacred Heart,NEC,22,420,79,151,79,151,0,0,24,41,28,70,98,11,5,8,35,53,182
Sacred Heart8,8,E.J. Anosike,FR,F,Sacred Heart,NEC,30,414,42,110,42,105,0,5,41,58,43,73,116,12,6,14,35,51,125
Sacred Heart9,9,Alex Watson,FR,G,Sacred Heart,NEC,26,404,33,86,20,42,13,44,14,19,7,31,38,21,13,5,25,41,93
Sacred Heart10,10,Chris Robinson,SR,G,Sacred Heart,NEC,21,301,25,81,16,40,9,41,16,20,21,41,62,17,11,1,17,26,75
Sacred Heart11,11,Jaecee Martin,FR,G,Sacred Heart,NEC,7,35,0,4,0,3,0,1,0,4,0,3,3,3,2,0,5,4,0
Sacred Heart12,12,Cavan LaRose,SR,F,Sacred Heart,NEC,5,10,0,0,0,0,0,0,1,2,0,0,0,0,0,0,0,2,1
Saint Francis (PA)1,1,Keith Braxton,SO,G,Saint Francis (PA),NEC,30,1057,176,364,136,258,40,106,129,160,49,240,289,100,52,17,79,53,521
Saint Francis (PA)2,2,Jamaal King,JR,G,Saint Francis (PA),NEC,30,924,190,396,139,243,51,153,117,143,11,81,92,105,37,1,92,68,548
Saint Francis (PA)3,3,Andre Wolford,JR,G,Saint Francis (PA),NEC,30,867,136,270,42,80,94,190,55,64,16,75,91,24,15,2,23,55,421
Saint Francis (PA)4,4,Randall Gaskins Jr.,SO,G,Saint Francis (PA),NEC,27,703,57,126,52,102,5,24,26,42,21,42,63,35,25,6,17,50,145
Saint Francis (PA)5,5,Deivydas Kuzavas,SO,F,Saint Francis (PA),NEC,30,600,73,124,73,123,0,1,26,41,48,75,123,10,4,15,15,80,172
Saint Francis (PA)6,6,Malik Harmon,SR,G,Saint Francis (PA),NEC,29,568,36,124,22,66,14,58,23,26,1,45,46,71,15,0,30,28,109
Saint Francis (PA)7,7,Mark Flagg,FR,F,Saint Francis (PA),NEC,30,533,69,134,68,128,1,6,45,71,56,69,125,19,20,23,34,69,184
Saint Francis (PA)8,8,Scott Meredith,JR,G,Saint Francis (PA),NEC,30,444,51,121,20,35,31,86,17,22,6,34,40,20,16,2,16,27,150
Saint Francis (PA)9,9,Daniel Wallace,SR,C,Saint Francis (PA),NEC,23,140,16,30,16,29,0,1,3,5,6,22,28,8,4,1,9,32,35
Saint Francis (PA)10,10,Isaiah Blackmon,JR,G,Saint Francis (PA),NEC,3,84,16,37,13,27,3,10,8,11,3,6,9,3,5,1,4,3,43
Saint Francis (PA)11,11,Markus Vallien,FR,G,Saint Francis (PA),NEC,13,50,5,19,4,12,1,7,9,14,0,2,2,3,5,0,5,6,20
Saint Francis (PA)12,12,Deon Baker,SR,G,Saint Francis (PA),NEC,11,48,9,18,9,18,0,0,1,1,5,6,11,2,2,0,5,4,19
Saint Francis (PA)13,13,Michael Klebon,JR,G,Saint Francis (PA),NEC,8,30,3,7,1,1,2,6,2,2,0,8,8,0,0,1,1,3,10
Saint Francis (PA)14,14,Jordan Forehand,JR,G,Saint Francis (PA),NEC,7,21,3,7,2,5,1,2,5,10,1,2,3,2,2,0,1,2,12
Saint Francis (PA)15,15,Tre McKeithen,JR,G,Saint Francis (PA),NEC,7,18,0,5,0,0,0,5,0,0,0,1,1,2,0,0,0,3,0
Saint Francis (PA)16,16,Dan Henry,FR,G,Saint Francis (PA),NEC,6,13,0,2,0,2,0,0,0,0,0,1,1,0,1,0,1,0,0
Saint Joseph's1,1,Shavar Newkirk,SR,G,Saint Joseph's,A-10,32,1092,172,443,120,284,52,159,162,212,25,114,139,125,50,7,56,57,558
Saint Joseph's2,2,James Demery,SR,F,Saint Joseph's,A-10,30,1024,195,408,173,330,22,78,96,151,49,116,165,33,35,10,46,48,508
Saint Joseph's3,3,Taylor Funk,FR,F,Saint Joseph's,A-10,32,920,127,298,43,85,84,213,41,49,33,123,156,43,25,15,34,72,379
Saint Joseph's4,4,Chris Clover,JR,G,Saint Joseph's,A-10,32,871,100,258,74,167,26,91,36,59,23,81,104,36,18,3,29,60,262
Saint Joseph's5,5,Pierfrancesco Oliva,SO,F,Saint Joseph's,A-10,31,851,72,146,53,88,19,58,43,86,35,177,212,93,26,21,63,85,206
Saint Joseph's6,6,Nick Robinson,SO,G,Saint Joseph's,A-10,31,804,81,175,65,129,16,46,61,76,34,127,161,77,30,12,46,92,239
Saint Joseph's7,7,Anthony Longpré,,F,Saint Joseph's,A-10,32,552,49,142,23,73,26,69,15,23,21,71,92,32,11,8,23,48,139
Saint Joseph's8,8,Lorenzo Edwards,SO,F,Saint Joseph's,A-10,19,165,11,42,4,8,7,34,4,8,15,24,39,3,3,10,4,18,33
Saint Joseph's9,9,Markell Lodge,,F,Saint Joseph's,A-10,15,60,5,6,5,6,0,0,1,3,3,7,10,0,3,4,3,6,11
Saint Joseph's10,10,Jai Williams,SR,F,Saint Joseph's,A-10,12,47,7,12,7,12,0,0,3,5,2,3,5,0,0,2,1,9,17
Saint Joseph's11,11,Lamarr Kimble,JR,G,Saint Joseph's,A-10,1,30,4,11,2,7,2,4,0,1,0,1,1,2,0,0,0,2,10
Saint Joseph's12,12,Kyle Thompson,SR,G,Saint Joseph's,A-10,8,11,0,1,0,1,0,0,2,2,0,1,1,0,1,0,2,0,2
Saint Joseph's13,13,Mike Booth,SR,G,Saint Joseph's,A-10,7,9,1,2,0,0,1,2,0,0,1,1,2,2,1,0,0,0,3
Saint Joseph's14,14,Christian Vega,,G,Saint Joseph's,A-10,4,5,0,3,0,3,0,0,0,0,0,0,0,1,0,0,0,0,0
Saint Joseph's15,15,Toliver Freeman,,G,Saint Joseph's,A-10,5,5,0,3,0,1,0,2,0,0,0,2,2,0,0,0,1,0,0
Saint Joseph's16,16,Gerald Blount,,F,Saint Joseph's,A-10,3,4,2,2,2,2,0,0,0,0,2,1,3,0,0,0,0,0,4
Saint Louis1,1,Javon Bess,JR,G,Saint Louis,A-10,33,1195,128,324,104,235,24,89,160,211,79,165,244,72,41,13,67,78,440
Saint Louis2,2,Davell Roby,SR,G,Saint Louis,A-10,33,1067,107,286,51,128,56,158,108,150,11,83,94,62,28,6,55,82,378
Saint Louis3,3,Hasahn French,FR,F,Saint Louis,A-10,32,965,129,241,129,240,0,1,40,110,94,133,227,48,24,59,63,105,298
Saint Louis4,4,Jalen Johnson,SO,F,Saint Louis,A-10,33,896,91,217,39,85,52,132,67,86,30,98,128,22,12,21,42,76,301
Saint Louis5,5,Jordan Goodwin,FR,G,Saint Louis,A-10,26,868,108,290,89,209,19,81,65,94,68,127,195,103,52,16,56,70,300
Saint Louis6,6,Aaron Hines,SR,G,Saint Louis,A-10,33,747,69,216,37,110,32,106,32,50,3,49,52,53,26,1,47,63,202
Saint Louis7,7,D.J. Foreman,JR,F,Saint Louis,A-10,32,619,87,139,87,138,0,1,46,91,36,72,108,27,11,10,55,80,220
Saint Louis8,8,Rashed Anthony,SR,C,Saint Louis,A-10,32,248,10,16,10,16,0,0,5,8,12,20,32,5,4,20,18,41,25
Saint Louis9,9,Markos Psimitis,JR,G,Saint Louis,A-10,11,20,2,5,0,0,2,5,0,2,1,0,1,1,0,0,1,1,6
Saint Mary's (CA)1,1,Emmett Naar,JR,G,Saint Mary's (CA),WCC,33,1169,123,252,100,195,23,57,65,75,11,67,78,264,28,5,95,39,334
Saint Mary's (CA)2,2,Jock Landale,JR,C,Saint Mary's (CA),WCC,33,1105,276,431,273,422,3,9,150,197,93,246,339,68,14,36,76,100,705
Saint Mary's (CA)3,3,Calvin Hermanson,JR,F,Saint Mary's (CA),WCC,33,1050,125,256,59,105,66,151,47,59,25,84,109,39,24,11,34,82,363
Saint Mary's (CA)4,4,Tanner Krebs,FR,G,Saint Mary's (CA),WCC,33,909,86,203,31,62,55,141,31,38,23,139,162,31,18,13,17,65,258
Saint Mary's (CA)5,5,Jordan Ford,FR,G,Saint Mary's (CA),WCC,33,871,129,258,86,158,43,100,42,55,13,74,87,52,24,2,27,43,343
Saint Mary's (CA)6,6,Evan Fitzner,SO,F,Saint Mary's (CA),WCC,33,515,57,121,33,60,24,61,15,18,21,73,94,9,7,8,19,58,153
Saint Mary's (CA)7,7,Cullen Neal,SR,G,Saint Mary's (CA),WCC,33,467,51,134,26,65,25,69,55,69,6,52,58,31,11,0,27,47,182
Saint Mary's (CA)8,8,Jordan Hunter,SO,C,Saint Mary's (CA),WCC,29,203,36,59,36,59,0,0,13,23,26,40,66,6,2,14,15,37,85
Saint Mary's (CA)9,9,Elijah Thomas,FR,F,Saint Mary's (CA),WCC,27,179,17,39,8,17,9,22,8,14,4,17,21,5,14,1,3,27,51
Saint Mary's (CA)10,10,Jock Perry,FR,C,Saint Mary's (CA),WCC,20,63,15,28,9,11,6,17,6,9,2,5,7,1,0,0,2,2,42
Saint Mary's (CA)11,11,Kyle Clark,SO,F,Saint Mary's (CA),WCC,3,60,5,8,5,6,0,2,2,2,3,1,4,1,0,0,0,5,12
Saint Mary's (CA)12,12,Tommy Kuhse,FR,G,Saint Mary's (CA),WCC,21,53,4,9,3,7,1,2,1,2,1,6,7,8,1,0,1,8,10
Saint Mary's (CA)13,13,Dan Sheets,FR,F,Saint Mary's (CA),WCC,5,6,1,1,1,1,0,0,0,0,0,1,1,0,0,0,0,1,2
Saint Peter's1,1,Nick Griffin,SR,G,Saint Peter's,MAAC,32,1045,141,369,68,168,73,201,48,65,10,83,93,40,16,7,42,43,403
Saint Peter's2,2,Nnamdi Enechionyia,SR,G,Saint Peter's,MAAC,32,852,56,165,27,76,29,89,31,41,21,63,84,39,19,9,39,57,172
Saint Peter's3,3,Quinn Taylor,SO,G,Saint Peter's,MAAC,32,848,79,162,68,125,11,37,72,95,54,129,183,53,33,9,65,94,241
Saint Peter's4,4,Davauhnte Turner,JR,G,Saint Peter's,MAAC,31,846,122,281,83,168,39,113,45,59,27,69,96,61,29,9,53,67,328
Saint Peter's5,5,Samuel Idowu,JR,F,Saint Peter's,MAAC,32,778,131,278,104,183,27,95,68,85,53,136,189,24,16,40,45,100,357
Saint Peter's6,6,Cameron Jones,SO,G,Saint Peter's,MAAC,32,724,64,177,26,68,38,109,30,43,16,66,82,43,30,4,46,80,196
Saint Peter's7,7,Elijah Gonzales,FR,G,Saint Peter's,MAAC,29,671,68,161,43,92,25,69,18,32,7,57,64,87,46,1,55,48,179
Saint Peter's8,8,Mamadou Ndaiye,JR,F,Saint Peter's,MAAC,31,362,49,95,41,78,8,17,30,53,40,61,101,10,5,7,20,56,136
Saint Peter's9,9,Julian Powell,JR,F,Saint Peter's,MAAC,30,252,23,43,22,34,1,9,7,10,16,30,46,9,8,14,15,44,54
Saint Peter's10,10,Jeremiah Livingston,JR,G,Saint Peter's,MAAC,19,168,6,30,4,19,2,11,3,5,7,7,14,12,9,1,12,12,17
Saint Peter's11,11,Amir Hicks,SO,G,Saint Peter's,MAAC,3,4,1,1,1,1,0,0,0,0,0,0,0,0,0,0,1,0,2
Sam Houston State1,1,John Dewey III,JR,G,Sam Houston State,Southland,33,963,98,275,56,156,42,119,95,112,24,75,99,144,32,0,99,76,333
Sam Houston State2,2,Christopher Galbreath Jr.,SR,F,Sam Houston State,Southland,33,912,202,418,187,372,15,46,71,107,84,173,257,42,21,18,70,88,490
Sam Houston State3,3,Marcus Harris,JR,G,Sam Houston State,Southland,33,844,93,251,55,126,38,125,95,122,15,77,92,34,31,2,38,77,319
Sam Houston State4,4,Jamal Williams,SR,G,Sam Houston State,Southland,33,814,102,205,93,183,9,22,55,85,69,111,180,56,34,4,48,52,268
Sam Houston State5,5,Josh Delaney,JR,G,Sam Houston State,Southland,32,694,74,182,16,40,58,142,34,44,5,50,55,67,24,2,27,51,240
Sam Houston State6,6,Abrian Edwards,JR,F,Sam Houston State,Southland,32,685,70,139,63,116,7,23,49,72,38,79,117,74,22,2,53,62,196
Sam Houston State7,7,Cameron Delaney,,G,Sam Houston State,Southland,32,453,40,124,18,45,22,79,24,29,16,73,89,25,16,5,23,50,126
Sam Houston State8,8,Albert Almanza,JR,G,Sam Houston State,Southland,22,379,40,112,10,27,30,85,4,9,12,36,48,14,12,3,11,46,114
Sam Houston State9,9,Josh Boutte,,F,Sam Houston State,Southland,20,280,46,73,46,73,0,0,15,24,33,38,71,5,1,7,16,45,107
Sam Houston State10,10,Freddy Bitondo,JR,F,Sam Houston State,Southland,25,170,12,25,12,25,0,0,5,17,17,17,34,3,1,1,6,40,29
Sam Houston State11,11,Bubba Furlong,FR,F,Sam Houston State,Southland,22,159,15,37,13,32,2,5,9,11,19,17,36,3,5,9,13,36,41
Sam Houston State12,12,Devin Jackson,JR,G,Sam Houston State,Southland,19,108,11,48,0,0,11,48,0,0,2,8,10,4,1,0,2,9,33
Sam Houston State13,13,Chidozie Ndu,FR,F,Sam Houston State,Southland,17,93,11,18,11,18,0,0,3,6,7,6,13,0,2,4,3,13,25
Sam Houston State14,14,Dajuan Jones,FR,G,Sam Houston State,Southland,11,57,8,21,6,12,2,9,3,10,1,7,8,8,0,0,9,4,21
Sam Houston State15,15,Justin Van Pelt,FR,C,Sam Houston State,Southland,5,14,2,2,2,2,0,0,0,0,0,6,6,0,0,0,2,4,4
Samford1,1,Justin Coleman,JR,G,Samford,Southern,32,1040,146,335,89,182,57,153,83,103,11,78,89,210,37,0,87,41,432
Samford2,2,Demetrius Dyson,,G,Samford,Southern,32,985,161,358,81,168,80,190,85,111,34,126,160,35,30,9,68,66,487
Samford3,3,Eric Adams,SR,F,Samford,Southern,32,765,126,185,126,185,0,0,69,93,80,127,207,18,43,46,45,90,321
Samford4,4,Alex Thompson,SR,F,Samford,Southern,30,741,127,281,87,154,40,127,53,68,20,92,112,21,12,7,22,66,347
Samford5,5,Josh Sharkey,SO,G,Samford,Southern,30,729,64,151,59,125,5,26,86,114,11,52,63,152,46,0,97,58,219
Samford6,6,Triston Chambers,SO,G,Samford,Southern,32,721,91,207,25,61,66,146,33,42,16,46,62,15,21,2,37,66,281
Samford7,7,Stefan Lakic,JR,F,Samford,Southern,32,403,55,104,38,60,17,44,15,18,11,48,59,6,9,2,24,44,142
Samford8,8,Kevion Nolan,FR,G,Samford,Southern,29,371,34,87,14,26,20,61,5,7,5,25,30,27,20,4,10,28,93
Samford9,9,Christen Cunningham,SR,G,Samford,Southern,9,260,30,67,27,50,3,17,6,7,7,19,26,36,5,1,23,4,69
Samford10,10,Alex Peters,SR,F,Samford,Southern,17,246,28,41,28,41,0,0,12,22,15,31,46,3,5,4,12,53,68
Samford11,11,Gerald Smith,JR,G,Samford,Southern,16,83,1,8,0,3,1,5,3,4,0,0,0,4,1,0,2,2,6
Samford12,12,Wyatt Walker,JR,C,Samford,Southern,2,35,7,15,7,15,0,0,4,5,4,6,10,1,0,1,2,8,18
Samford13,13,Tanner Tapp,JR,G,Samford,Southern,9,22,0,6,0,2,0,4,0,0,0,0,0,2,1,0,4,1,0
San Diego1,1,Olin Carter III,JR,G,San Diego,WCC,31,1093,129,335,50,111,79,224,49,62,9,87,96,51,26,18,34,76,386
San Diego2,2,Isaiah Wright,JR,G,San Diego,WCC,31,1060,131,299,85,179,46,120,104,143,11,144,155,162,40,4,93,84,412
San Diego3,3,Cameron Neubauer,SR,F,San Diego,WCC,31,895,63,169,25,50,38,119,36,53,24,83,107,45,16,8,49,93,200
San Diego4,4,Isaiah Pineiro,JR,F,San Diego,WCC,31,859,168,344,143,270,25,74,122,155,30,163,193,64,35,26,78,96,483
San Diego5,5,Tyler Williams,,G,San Diego,WCC,26,813,66,149,25,48,41,101,49,58,26,68,94,47,17,4,34,62,222
San Diego6,6,Juwan Gray,SO,F,San Diego,WCC,31,643,66,138,51,88,15,50,40,60,29,80,109,18,16,25,17,59,187
San Diego7,7,Yauhen Massalski,,F,San Diego,WCC,31,371,48,73,48,72,0,1,33,67,35,73,108,15,5,35,38,68,129
San Diego8,8,Alex Floresca,SO,F,San Diego,WCC,31,365,27,62,24,55,3,7,23,38,20,40,60,19,6,2,32,83,80
San Diego9,9,Hunter Summy,SO,G,San Diego,WCC,10,77,5,12,1,2,4,10,0,0,0,1,1,3,2,0,3,4,14
San Diego10,10,Jose Martinez,SO,F,San Diego,WCC,13,54,10,25,3,7,7,18,2,4,2,12,14,1,1,2,3,18,29
San Diego11,11,Vinny Ferrari,,G,San Diego,WCC,2,6,1,2,0,0,1,2,1,2,1,0,1,0,1,1,0,1,4
San Diego12,12,Jake Gilliam,,C,San Diego,WCC,2,6,3,4,3,4,0,0,1,3,3,1,4,0,0,0,1,3,7
San Diego13,13,Andy Nelson,,G,San Diego,WCC,3,4,0,0,0,0,0,0,0,1,0,0,0,1,0,0,0,1,0
San Diego14,14,Mitch Schafer,,G,San Diego,WCC,2,4,1,1,1,1,0,0,0,0,0,0,0,0,0,0,0,0,2
San Diego State1,1,Devin Watson,JR,G,San Diego State,MWC,32,1001,127,309,80,187,47,122,94,122,16,67,83,122,31,0,59,46,395
San Diego State2,2,Matt Mitchell,FR,F,San Diego State,MWC,32,855,115,256,66,120,49,136,64,83,23,106,129,56,36,8,66,79,343
San Diego State3,3,Malik Pope,SR,F,San Diego State,MWC,31,808,164,315,150,277,14,38,58,81,67,138,205,36,23,34,54,67,400
San Diego State4,4,Jalen McDaniels,FR,F,San Diego State,MWC,32,787,122,204,119,187,3,17,80,101,72,167,239,28,27,18,34,73,327
San Diego State5,5,Trey Kell,SR,G,San Diego State,MWC,27,759,94,241,68,154,26,87,68,92,17,91,108,110,31,6,42,34,282
San Diego State6,6,Jeremy Hemsley,JR,G,San Diego State,MWC,31,679,79,183,58,106,21,77,49,80,6,47,53,67,19,4,54,55,228
San Diego State7,7,Jordan Schakel,FR,G,San Diego State,MWC,32,446,33,100,6,22,27,78,11,17,17,50,67,18,12,3,9,65,104
San Diego State8,8,Max Montana,JR,F,San Diego State,MWC,25,412,57,148,17,38,40,110,20,28,19,56,75,20,8,4,17,46,174
San Diego State9,9,Kameron Rooks,SR,C,San Diego State,MWC,27,300,34,58,34,58,0,0,14,27,44,50,94,7,6,21,12,35,82
San Diego State10,10,Nolan Narain,SO,F,San Diego State,MWC,23,248,44,64,40,53,4,11,15,23,21,25,46,7,5,3,18,37,107
San Diego State11,11,Montaque Gill-Caesar,JR,G,San Diego State,MWC,7,78,10,26,6,13,4,13,6,9,4,11,15,4,2,1,9,5,30
San Diego State12,12,Michael Sohikish,JR,G,San Diego State,MWC,11,27,3,9,3,5,0,4,2,4,0,2,2,2,2,0,2,3,8
San Francisco1,1,Jordan Ratinho,SO,G,San Francisco,WCC,33,1009,123,276,52,104,71,172,35,54,27,77,104,37,22,11,28,67,352
San Francisco2,2,Frankie Ferrari,JR,G,San Francisco,WCC,33,921,132,304,78,166,54,138,57,67,5,73,78,139,35,0,51,64,375
San Francisco3,3,Chase Foster,SR,F,San Francisco,WCC,30,780,103,253,58,128,45,125,48,66,35,88,123,46,21,8,53,56,299
San Francisco4,4,Nate Renfro,JR,F,San Francisco,WCC,33,733,77,149,62,95,15,54,24,60,48,118,166,48,21,28,49,92,193
San Francisco5,5,Matthew McCarthy,JR,F,San Francisco,WCC,32,725,108,211,103,184,5,27,32,61,47,120,167,35,19,14,52,89,253
San Francisco6,6,Souley Boum,FR,G,San Francisco,WCC,30,620,93,253,55,149,38,104,109,130,20,61,81,35,16,5,53,55,333
San Francisco7,7,Jamaree Bouyea,FR,G,San Francisco,WCC,30,438,32,97,23,60,9,37,14,20,8,49,57,30,24,10,22,34,87
San Francisco8,8,Remu Raitanen,SO,F,San Francisco,WCC,29,429,32,104,15,35,17,69,26,31,23,53,76,16,9,2,17,36,107
San Francisco9,9,Taavi Jurkatamm,FR,F,San Francisco,WCC,26,307,17,45,14,33,3,12,0,6,19,37,56,14,8,14,8,48,37
San Francisco10,10,Jimbo Lull,SO,C,San Francisco,WCC,25,267,42,78,41,68,1,10,16,22,21,42,63,8,4,10,25,43,101
San Francisco11,11,Erik Poulsen,SO,C,San Francisco,WCC,24,221,32,92,20,43,12,49,12,22,17,30,47,7,3,4,15,36,88
San Francisco12,12,Mladen Djordjevic,JR,G,San Francisco,WCC,14,134,10,30,8,17,2,13,3,10,3,12,15,17,3,1,11,16,25
San Francisco13,13,Nick Loew,JR,F,San Francisco,WCC,8,64,6,9,6,9,0,0,4,6,6,7,13,3,2,1,2,7,16
San Francisco14,14,Michael Orlich,SO,G,San Francisco,WCC,2,2,0,0,0,0,0,0,0,0,0,0,0,0,0,0,2,0,0
San Jose State1,1,Ryan Welage,JR,F,San Jose State,MWC,30,1039,191,414,131,274,60,140,100,114,26,135,161,42,17,5,54,43,542
San Jose State2,2,Keith Fisher III,FR,F,San Jose State,MWC,30,769,122,248,122,248,0,0,68,105,56,134,190,26,25,7,61,96,312
San Jose State3,3,Jaycee Hillsman,JR,G,San Jose State,MWC,30,748,89,215,62,136,27,79,82,101,31,96,127,71,17,8,77,75,287
San Jose State4,4,Oumar Barry,JR,C,San Jose State,MWC,30,607,72,135,69,121,3,14,26,61,38,61,99,16,8,24,41,74,173
San Jose State5,5,Jalen James,SR,G,San Jose State,MWC,27,545,41,124,23,64,18,60,19,20,6,55,61,66,14,4,51,49,119
San Jose State6,6,Noah Baumann,FR,G,San Jose State,MWC,30,535,54,133,14,46,40,87,7,14,8,48,56,40,12,2,52,25,155
San Jose State7,7,Isaiah Nichols,SO,G,San Jose State,MWC,30,529,36,108,20,56,16,52,20,34,18,94,112,44,15,4,42,61,108
San Jose State8,8,Ashtin Chastain,SO,C,San Jose State,MWC,27,494,39,94,38,83,1,11,29,60,34,52,86,17,5,8,38,64,108
San Jose State9,9,Nai Carlisle,FR,G,San Jose State,MWC,19,331,26,61,21,49,5,12,20,27,7,28,35,35,9,0,22,34,77
San Jose State10,10,Caleb Simmons,FR,G,San Jose State,MWC,24,219,8,29,3,8,5,21,8,10,6,26,32,16,7,0,18,19,29
San Jose State11,11,Brandon Mitchell,,G,San Jose State,MWC,9,152,25,47,22,38,3,9,5,9,8,16,24,6,5,7,14,15,58
San Jose State12,12,Ryan Singer,JR,F,San Jose State,MWC,3,43,1,5,1,5,0,0,2,2,2,9,11,0,0,0,3,9,4
San Jose State13,13,Ryan Parilla,FR,G,San Jose State,MWC,5,39,1,5,1,5,0,0,0,1,1,2,3,6,1,0,2,5,2
Santa Clara1,1,Henry Caruso,SR,G,Santa Clara,WCC,31,1116,121,252,91,169,30,83,107,127,75,142,217,54,38,6,44,53,379
Santa Clara2,2,KJ Feagin,JR,G,Santa Clara,WCC,31,1085,201,454,140,290,61,164,79,91,12,53,65,125,26,3,72,69,542
Santa Clara3,3,Josip Vrankic,FR,F,Santa Clara,WCC,30,896,106,260,74,151,32,109,67,94,35,98,133,49,31,24,67,97,311
Santa Clara4,4,Matt Hauser,JR,G,Santa Clara,WCC,23,759,80,204,34,76,46,128,14,21,4,59,63,75,25,0,37,29,220
Santa Clara5,5,Emmanuel Ndumanya,SR,C,Santa Clara,WCC,31,705,64,125,64,125,0,0,56,92,56,97,153,21,26,15,46,106,184
Santa Clara6,6,Kai Healy,SR,G,Santa Clara,WCC,27,529,39,95,23,50,16,45,13,22,5,54,59,24,7,2,26,40,107
Santa Clara7,7,Jarvis Pugh,SR,F,Santa Clara,WCC,30,355,26,78,14,35,12,43,13,27,14,45,59,19,7,6,17,51,77
Santa Clara8,8,Shaquille Walters,FR,G,Santa Clara,WCC,21,311,31,67,24,45,7,22,10,18,2,35,37,15,4,3,17,25,79
Santa Clara9,9,Matt Turner,FR,G,Santa Clara,WCC,18,218,23,77,5,24,18,53,10,18,3,7,10,14,1,2,8,28,74
Santa Clara10,10,Henrik Jadersten,JR,F,Santa Clara,WCC,21,205,21,51,11,19,10,32,9,12,9,29,38,6,2,11,3,33,61
Santa Clara11,11,Julian Roche,FR,C,Santa Clara,WCC,6,32,6,8,6,8,0,0,2,2,4,1,5,0,1,1,2,4,14
Santa Clara12,12,Matt Jasaitis,SR,G,Santa Clara,WCC,4,11,0,3,0,0,0,3,0,0,0,1,1,2,0,0,1,2,0
Santa Clara13,13,Johnny Sawyer,SO,G,Santa Clara,WCC,1,3,0,0,0,0,0,0,0,0,1,0,1,0,0,0,0,0,0
Savannah State1,1,Dexter McClanahan,JR,G,Savannah State,MEAC,32,943,166,407,96,175,70,232,97,133,37,98,135,61,39,6,56,60,499
Savannah State2,2,Zach Sellers,SO,G,Savannah State,MEAC,32,848,117,264,76,132,41,132,55,72,24,77,101,123,40,5,68,58,330
Savannah State3,3,Alante Fenner,SR,G,Savannah State,MEAC,31,820,141,354,94,201,47,153,106,139,35,109,144,73,46,0,66,45,435
Savannah State4,4,Austin Dassent,SR,G,Savannah State,MEAC,32,705,89,235,28,59,61,176,42,73,30,80,110,55,35,3,38,62,281
Savannah State5,5,Javaris Jenkins,SR,F,Savannah State,MEAC,32,689,118,300,61,104,57,196,44,50,42,82,124,36,32,15,31,62,337
Savannah State6,6,Jahir Cabeza,SR,G,Savannah State,MEAC,30,508,68,148,42,69,26,79,22,35,32,59,91,24,21,27,24,59,184
Savannah State7,7,Ty'Lik Evans,,G,Savannah State,MEAC,27,492,75,222,47,98,28,124,47,69,47,40,87,69,36,0,48,57,225
Savannah State8,8,Maricus Glenn,SR,C,Savannah State,MEAC,32,313,21,41,21,37,0,4,14,26,29,38,67,12,9,9,24,70,56
Savannah State9,9,Ralueke Orizu,FR,F,Savannah State,MEAC,26,301,38,70,38,69,0,1,26,46,29,52,81,4,8,18,22,40,102
Savannah State10,10,Isaiah Felder,JR,G,Savannah State,MEAC,27,233,23,93,2,9,21,84,7,9,7,15,22,21,12,1,10,22,74
Savannah State11,11,John Grant Jr.,JR,F,Savannah State,MEAC,26,185,33,87,9,23,24,64,4,11,6,26,32,4,4,2,14,20,94
Savannah State12,12,Khalen Pinkett,JR,G,Savannah State,MEAC,24,165,12,28,9,21,3,7,9,17,7,14,21,17,12,0,13,29,36
Savannah State13,13,Jahlin Smith,JR,F,Savannah State,MEAC,10,111,15,36,13,24,2,12,2,4,11,25,36,2,6,1,15,13,34
Savannah State14,14,Chris Dubose,FR,G,Savannah State,MEAC,15,71,8,29,2,4,6,25,4,4,2,2,4,0,1,1,2,2,26
Savannah State15,15,Juwan Grant,SR,F,Savannah State,MEAC,15,68,13,26,10,16,3,10,4,6,5,10,15,1,0,1,3,6,33
Savannah State16,16,Trey Christopher,,G,Savannah State,MEAC,4,23,3,10,1,5,2,5,0,0,2,1,3,2,0,0,5,3,8
Seattle1,1,Jordan Hill,SR,G,Seattle,WAC,32,1069,144,360,74,166,70,194,75,97,19,98,117,104,39,14,95,102,433
Seattle2,2,Richaud Gittens,SR,G,Seattle,WAC,32,1002,112,279,70,148,42,131,64,86,54,108,162,52,37,6,54,98,330
Seattle3,3,Matej Kavas,SO,G,Seattle,WAC,32,1000,164,343,78,159,86,184,66,83,36,131,167,39,13,7,67,97,480
Seattle4,4,Josh Hearlihy,SR,G,Seattle,WAC,31,901,106,250,67,153,39,97,107,132,24,108,132,89,18,6,85,64,358
Seattle5,5,Morgan Means,SO,G,Seattle,WAC,33,898,101,255,72,153,29,102,56,71,22,96,118,93,27,3,75,78,287
Seattle6,6,Aaron Menzies,JR,C,Seattle,WAC,33,877,143,236,143,236,0,0,80,120,111,179,290,19,8,75,38,105,366
Seattle7,7,Scott Ulaneo,SO,F,Seattle,WAC,33,345,25,58,22,44,3,14,27,48,24,63,87,20,4,6,24,67,80
Seattle8,8,Aaron Nettles,FR,G,Seattle,WAC,31,237,25,58,5,8,20,50,13,17,4,17,21,9,6,0,9,20,83
Seattle9,9,Mattia Da Campo,SO,G,Seattle,WAC,27,198,15,24,11,15,4,9,7,11,15,29,44,17,9,0,7,29,41
Seattle10,10,Jake Spurgeon,SO,G,Seattle,WAC,20,102,7,28,5,7,2,21,8,10,3,10,13,5,0,1,7,13,24
Seattle11,11,Collin Huun,JR,G,Seattle,WAC,6,14,4,7,1,1,3,6,0,2,0,3,3,0,0,1,1,0,11
Seattle12,12,Brennan Corrigan,FR,G,Seattle,WAC,4,7,2,5,0,0,2,5,0,0,0,0,0,0,0,0,0,0,6
Seton Hall1,1,Khadeen Carrington,SR,G,Seton Hall,Big East,32,1057,155,380,110,249,45,131,122,146,20,82,102,145,34,9,73,68,477
Seton Hall2,2,Myles Powell,SO,G,Seton Hall,Big East,32,1017,162,368,73,137,89,231,80,102,16,63,79,94,33,8,64,76,493
Seton Hall3,3,Angel Delgado,SR,C,Seton Hall,Big East,32,986,173,346,173,344,0,2,81,135,124,246,370,85,26,22,80,70,427
Seton Hall4,4,Desi Rodriguez,SR,F,Seton Hall,Big East,29,875,194,386,141,246,53,140,75,102,32,111,143,62,29,14,60,70,516
Seton Hall5,5,Ismael Sanogo,SR,F,Seton Hall,Big East,30,689,63,116,53,93,10,23,29,51,48,106,154,29,31,28,27,86,165
Seton Hall6,6,Myles Cale,FR,G,Seton Hall,Big East,32,545,55,116,42,72,13,44,19,31,16,36,52,20,20,5,29,47,142
Seton Hall7,7,Michael Nzei,JR,F,Seton Hall,Big East,32,536,50,87,50,87,0,0,27,47,49,81,130,17,9,8,22,45,127
Seton Hall8,8,Sandro Mamukelashvili,FR,F,Seton Hall,Big East,32,311,32,68,24,41,8,27,15,25,27,34,61,15,8,16,13,45,87
Seton Hall9,9,Eron Gordon,SO,G,Seton Hall,Big East,28,230,16,35,10,20,6,15,6,15,5,19,24,21,4,0,12,21,44
Seton Hall10,10,Jordan Walker,FR,G,Seton Hall,Big East,17,123,10,31,4,12,6,19,5,12,2,7,9,15,6,1,12,29,31
Seton Hall11,11,Philip Flory,FR,G,Seton Hall,Big East,21,57,2,10,0,4,2,6,6,6,0,6,6,2,0,1,3,5,12
Seton Hall12,12,Shavar Reynolds,FR,G,Seton Hall,Big East,16,24,2,7,1,5,1,2,2,2,1,4,5,1,1,0,2,5,7
Siena1,1,Evan Fisher,JR,F,Siena,MAAC,32,896,89,205,62,134,27,71,46,62,31,126,157,26,12,23,52,88,251
Siena2,2,Ahsante Shivers,SO,G,Siena,MAAC,32,796,88,233,65,158,23,75,65,90,37,88,125,42,18,6,64,65,264
Siena3,3,Prince Oduro,FR,F,Siena,MAAC,31,795,121,250,121,250,0,0,41,123,48,109,157,23,7,21,66,100,283
Siena4,4,Roman Penn,FR,G,Siena,MAAC,23,742,67,164,43,93,24,71,65,78,38,74,112,69,29,5,45,68,223
Siena5,5,Khailil Richard,SO,G,Siena,MAAC,29,673,98,225,66,152,32,73,40,50,14,50,64,41,13,1,48,50,268
Siena6,6,Jordan Horn,FR,G,Siena,MAAC,30,592,78,206,30,69,48,137,34,43,19,52,71,31,17,4,34,37,238
Siena7,7,Kadeem Smithen,JR,G,Siena,MAAC,29,550,45,108,33,77,12,31,44,55,32,70,102,42,19,9,24,59,146
Siena8,8,Thomas Huerter Jr.,SO,F,Siena,MAAC,26,457,31,65,21,37,10,28,8,17,18,59,77,30,7,18,25,48,80
Siena9,9,Nico Clareth,JR,G,Siena,MAAC,15,398,71,189,38,100,33,89,52,60,9,42,51,27,12,7,45,52,227
Siena10,10,Christian Bentley,FR,G,Siena,MAAC,29,328,20,43,13,29,7,14,15,23,17,25,42,16,10,1,16,29,62
Siena11,11,Sammy Friday,SO,F,Siena,MAAC,25,190,22,51,22,51,0,0,19,31,30,30,60,2,3,6,12,28,63
Siena12,12,Manny Camper,,G,Siena,MAAC,16,109,10,17,9,15,1,2,11,18,6,13,19,2,5,2,5,10,32
Siena13,13,Kevin Degnan,JR,F,Siena,MAAC,18,89,11,33,9,25,2,8,2,2,6,14,20,4,1,1,7,6,26
Siena14,14,Paulo Morastoni,,G,Siena,MAAC,3,5,0,0,0,0,0,0,0,0,0,0,0,0,0,0,0,1,0
Siena15,15,Ben Diamond,SO,G,Siena,MAAC,5,5,1,1,0,0,1,1,0,0,0,0,0,0,0,0,1,0,3
South Alabama1,1,Rodrick Sikes,JR,G,South Alabama,Sun Belt,32,998,178,421,90,183,88,238,153,197,13,86,99,27,30,8,60,60,597
South Alabama2,2,Trhae Mitchell,SO,F,South Alabama,Sun Belt,32,956,82,178,69,142,13,36,47,76,31,162,193,81,29,44,54,83,224
South Alabama3,3,Josh Ajayi,SO,F,South Alabama,Sun Belt,31,919,144,296,131,248,13,48,99,133,55,151,206,31,16,13,70,57,400
South Alabama4,4,Herb McGee,SO,G,South Alabama,Sun Belt,32,845,84,208,36,72,48,136,49,68,11,75,86,95,16,3,80,79,265
South Alabama5,5,Nick Davis,SR,F,South Alabama,Sun Belt,30,732,66,144,48,81,18,63,19,40,37,135,172,29,23,31,43,87,169
South Alabama6,6,Dederick Lee,SR,G,South Alabama,Sun Belt,32,515,36,102,5,13,31,89,10,21,6,47,53,71,14,3,45,53,113
South Alabama7,7,Jordan Andrews,SO,G,South Alabama,Sun Belt,30,482,51,191,13,46,38,145,46,52,3,45,48,26,16,3,33,44,186
South Alabama8,8,Joe Thompson,FR,F,South Alabama,Sun Belt,26,298,23,59,21,46,2,13,21,36,23,45,68,4,6,8,17,37,69
South Alabama9,9,Kevin Morris,SO,F,South Alabama,Sun Belt,27,274,44,78,44,78,0,0,5,15,31,39,70,4,10,7,18,58,93
South Alabama10,10,John Pettway,FR,G,South Alabama,Sun Belt,24,231,28,61,27,60,1,1,19,27,4,23,27,22,7,2,25,28,76
South Alabama11,11,Rozelle Nix,SR,F,South Alabama,Sun Belt,13,120,15,31,15,31,0,0,0,2,11,14,25,3,1,2,18,21,30
South Alabama12,12,AJ Caldwell,FR,G,South Alabama,Sun Belt,4,20,1,8,1,1,0,7,2,3,1,3,4,2,0,1,2,2,4
South Alabama13,13,Ethan Haslam,SO,G,South Alabama,Sun Belt,8,18,0,2,0,1,0,1,1,2,1,2,3,0,0,0,1,3,1
South Alabama14,14,Devin Epps,SR,G,South Alabama,Sun Belt,9,17,0,4,0,2,0,2,1,2,1,0,1,1,3,0,1,0,1
South Carolina1,1,Frank Booker,SR,G,South Carolina,SEC,33,892,126,291,41,83,85,208,81,105,22,96,118,39,37,8,36,63,418
South Carolina2,2,Maik Kotsar,SO,F,South Carolina,SEC,33,875,107,251,101,224,6,27,43,77,58,99,157,47,31,17,58,91,263
South Carolina3,3,Justin Minaya,FR,F,South Carolina,SEC,32,860,90,231,51,124,39,107,35,51,52,82,134,47,20,8,40,64,254
South Carolina4,4,Chris Silva,JR,F,South Carolina,SEC,33,851,127,272,122,260,5,12,213,283,108,155,263,40,21,45,87,115,472
South Carolina5,5,Hassani Gravett,JR,G,South Carolina,SEC,30,778,75,188,47,101,28,87,44,64,17,92,109,107,12,7,68,58,222
South Carolina6,6,Wesley Myers,SR,G,South Carolina,SEC,33,725,81,213,51,136,30,77,66,99,21,61,82,56,21,4,47,77,258
South Carolina7,7,Felipe Haase,FR,F,South Carolina,SEC,33,647,71,186,46,92,25,94,25,34,35,93,128,32,16,5,34,61,192
South Carolina8,8,David Beatty,FR,G,South Carolina,SEC,29,342,30,118,20,65,10,53,16,22,7,21,28,24,12,2,23,41,86
South Carolina9,9,Evan Hinson,,G,South Carolina,SEC,23,232,20,57,12,35,8,22,15,28,5,25,30,7,6,4,18,31,63
South Carolina10,10,Jason Cudd,FR,F,South Carolina,SEC,23,156,9,23,9,23,0,0,12,17,9,13,22,3,0,3,5,19,30
South Carolina11,11,Kory Holden,JR,G,South Carolina,SEC,14,152,17,52,13,35,4,17,9,15,5,13,18,21,1,1,21,15,47
South Carolina12,12,Khadim Gueye,SO,F,South Carolina,SEC,17,88,0,2,0,2,0,0,0,2,5,7,12,0,2,1,5,16,0
South Carolina13,13,Ibrahim Famouke Doumbia,FR,F,South Carolina,SEC,12,43,3,13,3,10,0,3,2,4,2,8,10,0,1,0,0,10,8
South Carolina14,14,Christian Schmitt,SO,G,South Carolina,SEC,3,6,0,2,0,0,0,2,0,0,0,0,0,0,0,0,0,0,0
South Carolina15,15,Tommy Corchiani,SO,G,South Carolina,SEC,2,3,0,0,0,0,0,0,0,0,0,2,2,0,0,0,0,0,0
South Carolina State1,1,Damani Applewhite,SO,F,South Carolina State,MEAC,30,878,147,273,146,270,1,3,85,122,57,146,203,20,16,6,37,48,380
South Carolina State2,2,Janai Raynor Powell,JR,G,South Carolina State,MEAC,32,855,86,191,71,148,15,43,74,91,22,96,118,106,32,6,72,61,261
South Carolina State3,3,Donte Wright,SR,G,South Carolina State,MEAC,32,836,129,350,36,91,93,259,53,65,19,54,73,29,23,2,47,61,404
South Carolina State4,4,James Richardson,SR,G,South Carolina State,MEAC,29,690,111,289,74,180,37,109,36,54,20,35,55,30,33,14,37,38,295
South Carolina State5,5,Ian Kinard,SO,F,South Carolina State,MEAC,32,612,45,122,36,98,9,24,77,108,37,90,127,14,8,18,39,97,176
South Carolina State6,6,Justin Jones,SO,G,South Carolina State,MEAC,32,469,59,169,29,74,30,95,17,30,13,39,52,19,12,1,30,20,165
South Carolina State7,7,Patrell Rogers,,G,South Carolina State,MEAC,20,434,78,189,63,128,15,61,53,78,15,39,54,23,7,4,28,35,224
South Carolina State8,8,Ozante Fields,SO,F,South Carolina State,MEAC,27,410,56,104,56,104,0,0,22,41,46,65,111,10,5,10,30,73,134
South Carolina State9,9,Rayshawn Neal,FR,G,South Carolina State,MEAC,31,374,47,102,46,95,1,7,26,33,15,40,55,47,12,0,46,40,121
South Carolina State10,10,David Bottenberg,SO,F,South Carolina State,MEAC,29,330,29,64,29,64,0,0,20,26,24,29,53,8,4,1,8,50,78
South Carolina State11,11,Armani Taylor,SO,F,South Carolina State,MEAC,28,205,24,44,24,44,0,0,14,38,27,32,59,2,2,15,19,45,62
South Carolina State12,12,Ty Solomon,SR,G,South Carolina State,MEAC,9,165,5,17,4,13,1,4,7,10,3,12,15,25,10,0,11,16,18
South Carolina State13,13,Dwayne Banks,SO,G,South Carolina State,MEAC,27,140,7,21,3,13,4,8,6,6,6,8,14,18,5,0,24,23,24
South Carolina State14,14,Tarik Clement,SR,G,South Carolina State,MEAC,13,52,5,11,5,9,0,2,3,4,2,5,7,2,1,0,3,5,13
South Carolina Upstate1,1,Mike Cunningham,JR,G,South Carolina Upstate,A-Sun,31,1039,149,387,63,162,86,225,42,57,21,66,87,93,26,3,43,51,426
South Carolina Upstate2,2,Ramel Thompkins,SR,F,South Carolina Upstate,A-Sun,32,1004,113,276,40,84,73,192,46,54,38,147,185,28,23,33,35,73,345
South Carolina Upstate3,3,Malik Moore,JR,F,South Carolina Upstate,A-Sun,32,952,147,333,114,211,33,122,105,148,49,145,194,78,42,12,64,88,432
South Carolina Upstate4,4,Jure Span,JR,G,South Carolina Upstate,A-Sun,32,901,92,232,44,90,48,142,22,35,16,69,85,132,35,6,55,79,254
South Carolina Upstate5,5,Deion Holmes,JR,G,South Carolina Upstate,A-Sun,32,848,186,397,134,244,52,153,71,92,48,71,119,42,16,3,85,58,495
South Carolina Upstate6,6,Carson Smith,SR,F,South Carolina Upstate,A-Sun,31,478,50,104,40,67,10,37,8,11,28,45,73,33,11,1,18,66,118
South Carolina Upstate7,7,Avery Diggs,FR,C,South Carolina Upstate,A-Sun,31,431,53,94,52,89,1,5,13,23,43,68,111,8,7,16,24,62,120
South Carolina Upstate8,8,Isaiah Anderson,FR,C,South Carolina Upstate,A-Sun,27,303,35,71,33,64,2,7,8,17,26,41,67,10,10,9,14,40,80
South Carolina Upstate9,9,Thomas Booker,FR,G,South Carolina Upstate,A-Sun,28,303,42,100,31,76,11,24,19,21,24,15,39,11,17,1,15,34,114
South Carolina Upstate10,10,Pat Welch,JR,G,South Carolina Upstate,A-Sun,26,179,14,46,2,3,12,43,0,2,6,12,18,13,8,2,6,12,40
South Carolina Upstate11,11,Austin Nelson,FR,G,South Carolina Upstate,A-Sun,3,7,0,4,0,2,0,2,0,0,1,0,1,1,0,0,1,1,0
South Carolina Upstate12,12,Yeskin Walker-Williams,FR,F,South Carolina Upstate,A-Sun,2,5,0,1,0,1,0,0,0,0,0,0,0,0,0,0,1,2,0
South Dakota1,1,Triston Simpson,SO,G,South Dakota,Summit,34,1038,106,235,76,150,30,85,49,74,15,58,73,107,28,1,59,63,291
South Dakota2,2,Matt Mooney,JR,G,South Dakota,Summit,33,1009,219,482,145,280,74,202,103,125,17,111,128,102,67,4,80,62,615
South Dakota3,3,Trey Burch-Manning,JR,F,South Dakota,Summit,34,844,112,225,106,209,6,16,60,93,56,171,227,49,32,3,42,90,290
South Dakota4,4,Tyler Peterson,SO,G,South Dakota,Summit,34,825,100,207,79,138,21,69,49,64,27,85,112,64,30,4,44,86,270
South Dakota5,5,Tyler Hagedorn,JR,F,South Dakota,Summit,33,817,150,341,108,233,42,108,93,113,49,143,192,37,24,25,45,81,435
South Dakota6,6,Nick Fuller,SR,F,South Dakota,Summit,34,557,108,196,97,156,11,40,68,85,44,93,137,16,12,11,29,76,295
South Dakota7,7,Brandon Armstrong,SO,G,South Dakota,Summit,34,498,62,139,28,58,34,81,26,37,5,53,58,24,7,1,12,21,184
South Dakota8,8,Carlton Hurst,SR,G,South Dakota,Summit,21,479,47,78,44,68,3,10,35,51,32,60,92,17,17,7,23,29,132
South Dakota9,9,Austin Sparks,SR,F,South Dakota,Summit,29,188,16,30,16,30,0,0,13,16,10,21,31,4,3,3,8,18,45
South Dakota10,10,Dan Jech,JR,F,South Dakota,Summit,23,165,29,48,29,45,0,3,17,22,15,26,41,7,2,3,9,26,75
South Dakota11,11,Joshua Doss,SR,G,South Dakota,Summit,25,151,12,20,11,15,1,5,13,15,9,30,39,6,7,1,8,9,38
South Dakota12,12,Logan Power,JR,F,South Dakota,Summit,19,85,16,27,7,11,9,16,3,6,5,19,24,10,2,0,5,4,44
South Dakota13,13,Jack Stensgard,FR,G,South Dakota,Summit,13,55,3,13,0,6,3,7,0,0,1,3,4,6,2,0,1,2,9
South Dakota14,14,Stanley Umude,FR,G,South Dakota,Summit,13,47,4,14,4,11,0,3,7,10,0,7,7,2,1,2,6,3,15
South Dakota15,15,Josh Williams,FR,G,South Dakota,Summit,12,42,7,11,4,5,3,6,0,0,0,2,2,2,0,0,2,1,17
South Dakota State1,1,Mike Daum,JR,F,South Dakota State,Summit,34,1053,264,571,173,355,91,216,190,222,63,290,353,45,17,25,68,82,809
South Dakota State2,2,Reed Tellinghuisen,SR,G,South Dakota State,Summit,34,1046,138,295,76,138,62,157,71,98,31,130,161,53,17,20,26,73,409
South Dakota State3,3,"David Jenkins, Jr.",FR,G,South Dakota State,Summit,34,994,179,407,97,195,82,212,109,138,9,102,111,55,12,0,56,64,549
South Dakota State4,4,Tevin King,JR,G,South Dakota State,Summit,34,917,118,225,100,169,18,56,61,85,48,139,187,103,59,8,58,106,315
South Dakota State5,5,Skyler Flatten,SR,G,South Dakota State,Summit,34,896,84,167,29,58,55,109,15,21,16,90,106,41,16,12,12,43,238
South Dakota State6,6,Brandon Key,JR,G,South Dakota State,Summit,33,603,66,147,57,111,9,36,56,81,9,39,48,108,18,0,52,33,197
South Dakota State7,7,Ian Theisen,SR,F,South Dakota State,Summit,30,523,47,96,29,43,18,53,29,41,32,74,106,15,9,7,12,60,141
South Dakota State8,8,Lane Severyn,SR,G,South Dakota State,Summit,33,494,35,66,13,24,22,42,15,23,33,39,72,21,13,6,16,56,107
South Dakota State9,9,Chris Howell,JR,G,South Dakota State,Summit,23,300,43,90,41,87,2,3,19,34,16,63,79,18,8,0,30,24,107
South Dakota State10,10,Dallas Polk-Hilliard,JR,F,South Dakota State,Summit,5,35,5,12,3,7,2,5,1,2,2,5,7,0,0,0,2,5,13
South Dakota State11,11,Beau Brown,SO,G,South Dakota State,Summit,7,14,0,8,0,1,0,7,0,0,0,0,0,0,0,0,0,1,0
South Florida1,1,Stephan Jiggetts,,G,South Florida,AAC,32,1089,133,360,72,206,61,154,73,90,11,81,92,104,21,3,75,73,400
South Florida2,2,Terrence Samuel,SR,G,South Florida,AAC,32,909,60,153,47,121,13,32,77,96,19,112,131,93,35,0,69,51,210
South Florida3,3,Payton Banks,SR,F,South Florida,AAC,29,823,108,289,47,107,61,182,54,72,18,87,105,34,35,6,52,75,331
South Florida4,4,Malik Martin,JR,F,South Florida,AAC,32,744,85,146,76,127,9,19,26,46,47,105,152,17,17,30,44,51,205
South Florida5,5,David Collins,FR,G,South Florida,AAC,27,668,84,169,64,121,20,48,81,111,13,53,66,65,28,3,70,82,269
South Florida6,6,Justin Brown,FR,G,South Florida,AAC,32,658,62,173,27,63,35,110,16,21,39,48,87,24,8,2,30,62,175
South Florida7,7,Isaiah Manderson,SR,F,South Florida,AAC,26,547,89,175,89,171,0,4,33,52,44,71,115,18,7,5,34,40,211
South Florida8,8,Nikola Scekic,JR,C,South Florida,AAC,32,496,31,83,28,77,3,6,7,17,30,52,82,4,0,17,21,66,72
South Florida9,9,Tulio Da Silva,SO,F,South Florida,AAC,19,442,55,136,50,118,5,18,37,53,25,81,106,16,10,10,37,42,152
South Florida10,10,Henry Beard,SO,G,South Florida,AAC,16,33,0,4,0,4,0,0,1,2,0,3,3,2,1,0,1,4,1
South Florida11,11,Yito Alvarado,SO,F,South Florida,AAC,8,10,0,2,0,1,0,1,0,0,2,1,3,1,1,0,1,0,0
South Florida12,12,Joey Coffaro,FR,G,South Florida,AAC,4,6,0,1,0,1,0,0,0,0,1,0,1,1,0,0,0,0,0
Southeast Missouri State1,1,Jonathan Dalton,JR,G,Southeast Missouri State,OVC,31,998,51,107,32,57,19,50,42,62,19,50,69,168,38,0,62,61,163
Southeast Missouri State2,2,Denzel Mahoney,SO,G,Southeast Missouri State,OVC,31,969,176,380,112,225,64,155,182,218,45,113,158,39,28,5,51,91,598
Southeast Missouri State3,3,Ledarrius Brewer,FR,G,Southeast Missouri State,OVC,31,912,152,362,81,166,71,196,74,100,14,104,118,40,29,16,57,66,449
Southeast Missouri State4,4,Daniel Simmons,SR,G,Southeast Missouri State,OVC,31,773,131,284,84,180,47,104,71,105,14,101,115,61,32,3,57,68,380
Southeast Missouri State5,5,Justin Carpenter,FR,F,Southeast Missouri State,OVC,30,641,99,189,93,167,6,22,51,76,58,83,141,21,13,13,35,80,255
Southeast Missouri State6,6,Milos Vranes,SR,F,Southeast Missouri State,OVC,30,566,64,142,31,57,33,85,16,30,29,91,120,18,12,6,43,62,177
Southeast Missouri State7,7,Ray Kowalski,FR,G,Southeast Missouri State,OVC,26,437,43,112,13,38,30,74,12,12,4,27,31,17,6,0,21,24,128
Southeast Missouri State8,8,Mark Laros,JR,C,Southeast Missouri State,OVC,27,405,48,76,48,72,0,4,7,15,40,54,94,9,8,11,28,36,103
Southeast Missouri State9,9,Donnie Lewis,JR,G,Southeast Missouri State,OVC,31,315,5,12,1,3,4,9,7,15,7,17,24,41,9,0,14,37,21
Southeast Missouri State10,10,Isaiah Gable,FR,F,Southeast Missouri State,OVC,17,191,22,55,9,19,13,36,7,11,5,23,28,6,0,0,7,19,64
Southeast Missouri State11,11,Dondre Duffus,,G,Southeast Missouri State,OVC,3,43,5,10,3,7,2,3,5,6,0,5,5,3,3,0,6,9,17
Southeastern Louisiana1,1,Marlain Veal,JR,G,Southeastern Louisiana,Southland,33,1108,139,309,103,211,36,98,117,156,31,143,174,202,66,4,111,76,431
Southeastern Louisiana2,2,Joshua Filmore,SR,G,Southeastern Louisiana,Southland,29,898,93,235,21,47,72,188,18,30,8,58,66,61,24,0,30,30,276
Southeastern Louisiana3,3,Jabbar Singleton,SR,G,Southeastern Louisiana,Southland,29,806,59,145,19,46,40,99,30,44,6,38,44,66,26,0,38,45,188
Southeastern Louisiana4,4,Keith Charleston,JR,G,Southeastern Louisiana,Southland,33,711,54,129,34,82,20,47,21,48,43,92,135,45,13,8,48,68,149
Southeastern Louisiana5,5,Moses Greenwood,JR,F,Southeastern Louisiana,Southland,32,708,136,250,132,238,4,12,53,78,70,111,181,13,14,30,59,85,329
Southeastern Louisiana6,6,Jordan Capps,SR,F,Southeastern Louisiana,Southland,32,667,169,314,151,264,18,50,66,121,36,101,137,17,15,29,63,78,422
Southeastern Louisiana7,7,Eddy Polanco,SR,G,Southeastern Louisiana,Southland,32,611,68,188,32,80,36,108,90,113,32,77,109,53,20,5,44,46,262
Southeastern Louisiana8,8,James Currington,SR,F,Southeastern Louisiana,Southland,27,550,87,166,87,161,0,5,31,63,68,72,140,12,34,16,28,61,205
Southeastern Louisiana9,9,Quinton Thomas,SR,G,Southeastern Louisiana,Southland,27,250,19,49,12,19,7,30,18,25,6,31,37,11,6,3,16,29,63
Southeastern Louisiana10,10,Brandon Gonzalez,FR,F,Southeastern Louisiana,Southland,19,152,16,29,8,12,8,17,3,4,7,15,22,4,3,1,8,29,43
Southeastern Louisiana11,11,D'Angelo West,,G,Southeastern Louisiana,Southland,18,139,8,43,0,5,8,38,2,2,1,7,8,6,1,0,6,12,26
Southern1,1,Jared Sam,SR,F,Southern,SWAC,33,1106,178,405,177,404,1,1,181,236,102,188,290,43,28,25,75,66,538
Southern2,2,Eddie Reese,JR,G,Southern,SWAC,31,905,107,266,46,98,61,168,68,97,18,80,98,104,35,14,72,61,343
Southern3,3,Emanual Shepherd,SR,F,Southern,SWAC,33,817,90,193,89,190,1,3,38,69,63,115,178,38,22,24,43,78,219
Southern4,4,Jamar Sandfer,SO,G,Southern,SWAC,33,739,94,228,64,149,30,79,52,65,43,79,122,46,25,17,46,94,270
Southern5,5,Chris Thomas,SR,G,Southern,SWAC,31,688,71,188,58,134,13,54,31,62,34,76,110,19,10,10,27,61,186
Southern6,6,Torrey Mayo,JR,G,Southern,SWAC,30,472,19,58,14,39,5,19,17,32,6,31,37,45,15,2,35,60,60
Southern7,7,Aaron Ray,JR,G,Southern,SWAC,29,412,46,129,24,77,22,52,35,57,19,62,81,13,19,1,37,62,149
Southern8,8,Sidney Umude,,F,Southern,SWAC,22,403,69,146,69,144,0,2,44,66,39,63,102,9,7,11,27,36,182
Southern9,9,LaQuentin Collins,SR,G,Southern,SWAC,32,363,27,79,12,38,15,41,28,41,12,39,51,25,10,5,29,26,97
Southern10,10,Richard Lee,SR,G,Southern,SWAC,25,228,32,90,14,32,18,58,6,8,3,17,20,7,4,0,6,17,88
Southern11,11,Mubashar Ali,FR,F,Southern,SWAC,24,169,20,51,20,50,0,1,23,34,15,29,44,3,2,7,16,24,63
Southern12,12,DeRias Johnson,SO,G,Southern,SWAC,20,142,11,54,4,16,7,38,3,4,4,14,18,11,6,1,6,16,32
Southern13,13,Shaquille Benson,JR,C,Southern,SWAC,12,78,8,25,8,25,0,0,5,9,16,11,27,0,4,3,7,16,21
Southern14,14,Patrick Smith,SR,F,Southern,SWAC,5,69,5,15,4,12,1,3,4,8,5,3,8,2,0,1,2,7,15
Southern15,15,Brendon Ganaway,SO,G,Southern,SWAC,6,52,4,8,1,3,3,5,5,5,1,0,1,5,0,0,3,5,16
Southern16,16,Rashad Andrews,SR,G,Southern,SWAC,3,7,0,1,0,1,0,0,0,0,0,0,0,0,0,0,0,0,0
Southern California1,1,Jordan McLaughlin,SR,G,Southern California,Pac-12,34,1187,143,319,94,195,49,124,86,114,26,102,128,254,68,8,85,37,421
Southern California2,2,Chimezie Metu,JR,F,Southern California,Pac-12,34,1053,205,393,193,353,12,40,111,152,64,189,253,53,27,59,68,87,533
Southern California3,3,Elijah Stewart,SR,G,Southern California,Pac-12,34,988,128,288,65,124,63,164,60,72,30,72,102,44,23,21,28,64,379
Southern California4,4,Jonah Mathews,SO,G,Southern California,Pac-12,32,852,111,237,55,108,56,129,25,41,19,64,83,30,18,5,25,54,303
Southern California5,5,Nick Rakocevic,SO,F,Southern California,Pac-12,34,686,110,177,110,177,0,0,37,64,87,107,194,16,24,18,29,101,257
Southern California6,6,Bennie Boatwright,JR,F,Southern California,Pac-12,23,638,107,258,61,126,46,132,53,73,39,108,147,45,7,19,32,42,313
Southern California7,7,Shaqquan Aaron,JR,G,Southern California,Pac-12,33,513,58,123,37,61,21,62,8,21,11,52,63,26,10,5,29,52,145
Southern California8,8,Jordan Usher,FR,G,Southern California,Pac-12,34,450,51,115,30,63,21,52,22,29,20,48,68,33,17,3,23,60,145
Southern California9,9,Derryck Thornton,SO,G,Southern California,Pac-12,23,325,28,82,21,60,7,22,21,22,2,31,33,29,18,3,29,20,84
Southern California10,10,"Charles O'Bannon, Jr.",,G,Southern California,Pac-12,14,72,5,23,4,15,1,8,7,7,1,8,9,2,4,0,2,10,18
Southern California11,11,Victor Uyaelunmo,FR,F,Southern California,Pac-12,12,39,4,6,4,6,0,0,6,8,2,6,8,1,0,1,2,6,14
Southern California12,12,Harrison Henderson,SO,F,Southern California,Pac-12,11,26,2,10,2,8,0,2,0,0,2,4,6,0,0,0,1,6,4
Southern California13,13,Kurt Karis,SR,G,Southern California,Pac-12,9,18,0,1,0,1,0,0,2,4,1,2,3,0,1,0,1,2,2
Southern California14,14,Devin Fleming,JR,G,Southern California,Pac-12,3,3,1,2,1,1,0,1,0,0,0,2,2,0,0,0,0,0,2
Southern Illinois1,1,Sean Lloyd,JR,G,Southern Illinois,MVC,33,1146,142,302,113,225,29,77,85,116,47,116,163,69,51,17,61,78,398
Southern Illinois2,2,Armon Fletcher,JR,G,Southern Illinois,MVC,32,1011,153,315,113,200,40,115,106,145,46,116,162,54,38,16,41,73,452
Southern Illinois3,3,Aaron Cook,SO,G,Southern Illinois,MVC,33,989,107,245,70,147,37,98,71,102,7,69,76,90,47,9,74,61,322
Southern Illinois4,4,Kavion Pippen,JR,C,Southern Illinois,MVC,33,901,179,325,179,325,0,0,41,63,58,138,196,31,22,45,54,92,399
Southern Illinois5,5,Tyler Smithpeters,SR,G,Southern Illinois,MVC,33,836,81,200,31,62,50,138,44,63,20,123,143,77,37,5,47,80,256
Southern Illinois6,6,Marcus Bartley,,G,Southern Illinois,MVC,26,709,57,153,16,46,41,107,19,24,0,37,37,90,22,7,55,75,174
Southern Illinois7,7,Jonathan Wiley,SR,F,Southern Illinois,MVC,22,420,51,108,51,105,0,3,26,40,23,77,100,21,9,11,23,50,128
Southern Illinois8,8,Rudy Stradnieks,JR,F,Southern Illinois,MVC,31,321,43,87,40,67,3,20,12,18,16,36,52,13,3,2,25,51,101
Southern Illinois9,9,Eric McGill,JR,G,Southern Illinois,MVC,10,192,18,51,8,23,10,28,4,10,5,22,27,13,15,1,16,15,50
Southern Illinois10,10,Brendon Gooch,FR,F,Southern Illinois,MVC,25,138,6,21,1,4,5,17,5,11,9,25,34,5,3,5,4,7,22
Southern Illinois11,11,Austin Weiher,JR,F,Southern Illinois,MVC,13,36,2,10,2,9,0,1,2,2,0,4,4,1,0,0,2,6,6
Southern Illinois12,12,John Gardner,,F,Southern Illinois,MVC,1,1,0,0,0,0,0,0,0,2,0,0,0,0,0,0,0,0,0
Southern Illinois-Edwardsville1,1,Christian Ellis,FR,G,Southern Illinois-Edwardsville,OVC,30,815,97,206,90,183,7,23,66,108,32,103,135,101,23,0,81,109,267
Southern Illinois-Edwardsville2,2,Jalen Henry,JR,F,Southern Illinois-Edwardsville,OVC,29,815,157,374,120,272,37,102,118,165,45,166,211,34,23,24,73,84,469
Southern Illinois-Edwardsville3,3,Keenan Simmons,JR,F,Southern Illinois-Edwardsville,OVC,30,754,84,142,83,139,1,3,24,38,68,89,157,10,4,31,26,96,193
Southern Illinois-Edwardsville4,4,Justin Benton,FR,G,Southern Illinois-Edwardsville,OVC,26,749,61,136,36,84,25,52,23,34,14,41,55,70,15,1,42,61,170
Southern Illinois-Edwardsville5,5,Daniel Kinchen,JR,G,Southern Illinois-Edwardsville,OVC,30,743,103,302,42,105,61,197,75,83,8,42,50,68,18,1,63,47,342
Southern Illinois-Edwardsville6,6,David McFarland,JR,G,Southern Illinois-Edwardsville,OVC,29,685,84,227,46,93,38,134,41,53,19,78,97,44,32,4,36,76,247
Southern Illinois-Edwardsville7,7,Brandon Jackson,FR,F,Southern Illinois-Edwardsville,OVC,30,470,62,123,62,118,0,5,26,43,31,38,69,8,5,8,32,61,150
Southern Illinois-Edwardsville8,8,Jaylin McCoy,JR,G,Southern Illinois-Edwardsville,OVC,24,402,42,120,14,35,28,85,11,13,2,17,19,18,11,0,17,28,123
Southern Illinois-Edwardsville9,9,D.J. Jackson,FR,F,Southern Illinois-Edwardsville,OVC,19,183,13,33,11,21,2,12,7,11,15,14,29,4,5,0,5,20,35
Southern Illinois-Edwardsville10,10,Bill Awet,FR,F,Southern Illinois-Edwardsville,OVC,21,180,9,31,9,25,0,6,7,11,8,31,39,6,4,9,15,33,25
Southern Illinois-Edwardsville11,11,Kevion Stewart,FR,G,Southern Illinois-Edwardsville,OVC,17,127,8,27,0,4,8,23,5,6,4,14,18,8,3,0,6,13,29
Southern Illinois-Edwardsville12,12,Julian Torres,SO,F,Southern Illinois-Edwardsville,OVC,5,73,13,33,9,25,4,8,4,8,6,10,16,2,1,4,8,16,34
Southern Illinois-Edwardsville13,13,D'Quan Applewhite,,G,Southern Illinois-Edwardsville,OVC,4,4,1,5,0,1,1,4,3,7,1,1,2,0,0,0,0,1,6
Southern Methodist1,1,Jimmy Whitt,SO,G,Southern Methodist,AAC,33,1096,140,287,134,266,6,21,60,101,50,121,171,114,60,16,54,75,346
Southern Methodist2,2,Ben Emelogu,SR,G,Southern Methodist,AAC,33,1047,122,265,59,131,63,134,43,60,49,131,180,56,43,5,51,87,350
Southern Methodist3,3,Shake Milton,JR,G,Southern Methodist,AAC,22,800,123,274,67,145,56,129,94,111,14,89,103,96,31,14,50,38,396
Southern Methodist4,4,Jahmal McMurray,,G,Southern Methodist,AAC,22,690,116,271,54,119,62,152,30,36,17,42,59,34,15,1,38,37,324
Southern Methodist5,5,Ethan Chargois,FR,F,Southern Methodist,AAC,31,661,101,218,66,113,35,105,44,77,46,89,135,33,25,21,41,82,281
Southern Methodist6,6,Jarrey Foster,JR,G,Southern Methodist,AAC,19,616,97,208,77,146,20,62,37,53,53,60,113,51,14,23,28,36,251
Southern Methodist7,7,Elijah Landrum,FR,G,Southern Methodist,AAC,32,565,36,123,17,46,19,77,10,16,11,40,51,34,25,3,17,43,101
Southern Methodist8,8,William Douglas,FR,G,Southern Methodist,AAC,33,478,18,73,6,34,12,39,18,24,25,38,63,31,21,3,33,57,66
Southern Methodist9,9,Akoy Agau,SR,F,Southern Methodist,AAC,27,436,44,86,39,71,5,15,42,60,36,60,96,17,7,12,33,48,135
Southern Methodist10,10,Everett Ray,FR,F,Southern Methodist,AAC,16,160,14,22,12,19,2,3,6,20,19,24,43,7,2,1,9,27,36
Southern Methodist11,11,James Pyle,SO,G,Southern Methodist,AAC,19,38,1,5,1,2,0,3,0,2,1,1,2,1,0,0,2,4,2
Southern Methodist12,12,Luke Wilfong,FR,G,Southern Methodist,AAC,11,13,2,3,1,2,1,1,0,0,1,0,1,0,1,0,0,1,5
Southern Mississippi1,1,Cortez Edwards,JR,G,Southern Mississippi,CUSA,34,1224,221,449,196,361,25,88,99,128,70,144,214,98,71,14,62,54,566
Southern Mississippi2,2,Tyree Griffin,JR,G,Southern Mississippi,CUSA,34,1212,181,420,126,266,55,154,92,132,25,113,138,201,59,3,89,58,509
Southern Mississippi3,3,Kevin Holland,JR,G,Southern Mississippi,CUSA,34,1126,80,192,21,50,59,142,11,14,10,53,63,48,26,4,17,70,230
Southern Mississippi4,4,Dominic Magee,JR,G,Southern Mississippi,CUSA,32,841,127,285,85,160,42,125,78,121,26,184,210,47,28,5,42,60,374
Southern Mississippi5,5,D'Angelo Richardson,,G,Southern Mississippi,CUSA,34,661,50,139,32,71,18,68,38,46,6,43,49,59,19,2,41,72,156
Southern Mississippi6,6,Tim Rowe,SO,F,Southern Mississippi,CUSA,31,507,54,110,51,94,3,16,20,36,19,66,85,11,8,17,20,72,131
Southern Mississippi7,7,Eddie Davis,JR,F,Southern Mississippi,CUSA,31,476,59,103,47,73,12,30,26,34,34,30,64,14,7,8,27,70,156
Southern Mississippi8,8,LaDavius Draine,FR,G,Southern Mississippi,CUSA,28,330,58,125,28,50,30,75,9,18,15,47,62,8,7,2,7,33,155
Southern Mississippi9,9,Anfernee Hampton,JR,G,Southern Mississippi,CUSA,28,324,41,110,31,69,10,41,25,33,15,37,52,8,9,4,12,23,117
Southern Mississippi10,10,Clay Weatherspoon,SO,G,Southern Mississippi,CUSA,14,78,1,10,1,6,0,4,3,5,3,8,11,0,1,0,2,8,5
Southern Mississippi11,11,Josh Conley,SO,G,Southern Mississippi,CUSA,7,41,0,5,0,4,0,1,2,4,0,5,5,2,0,0,2,6,2
Southern Mississippi12,12,Rodney Gill,JR,G,Southern Mississippi,CUSA,9,31,0,10,0,5,0,5,0,2,2,2,4,4,2,0,1,2,0
Southern Utah1,1,Jadon Cohee,JR,G,Southern Utah,Big Sky,32,1076,126,317,80,194,46,123,105,132,3,76,79,98,15,2,61,65,403
Southern Utah2,2,James McGee,SR,G,Southern Utah,Big Sky,31,928,78,199,27,66,51,133,63,83,7,57,64,75,26,8,32,66,270
Southern Utah3,3,Dre Marin,FR,G,Southern Utah,Big Sky,31,900,70,176,36,72,34,104,56,72,16,100,116,61,31,5,50,87,230
Southern Utah4,4,Brandon Better,JR,G,Southern Utah,Big Sky,31,748,123,324,55,147,68,177,82,97,13,61,74,40,29,1,67,66,396
Southern Utah5,5,Jamal Aytes,SR,F,Southern Utah,Big Sky,32,681,164,281,163,279,1,2,76,103,53,115,168,21,16,8,47,102,405
Southern Utah6,6,Dwayne Morgan,,F,Southern Utah,Big Sky,21,530,103,214,96,186,7,28,44,70,29,111,140,19,13,19,55,85,257
Southern Utah7,7,Jacob Calloway,SO,F,Southern Utah,Big Sky,30,482,43,131,19,58,24,73,30,41,34,73,107,25,14,8,23,53,140
Southern Utah8,8,Christian Musoko,SR,F,Southern Utah,Big Sky,29,471,71,124,71,124,0,0,35,61,36,84,120,11,5,16,29,95,177
Southern Utah9,9,Ivan Madunic,SO,F,Southern Utah,Big Sky,30,397,32,76,13,27,19,49,14,24,33,73,106,10,11,29,24,52,97
Southern Utah10,10,Matthew Johnson,JR,G,Southern Utah,Big Sky,15,96,4,18,1,5,3,13,3,4,2,6,8,6,4,0,2,11,14
Southern Utah11,11,Jamil Jackson,SO,G,Southern Utah,Big Sky,5,71,6,14,6,11,0,3,2,2,1,1,2,5,2,1,3,9,14
Southern Utah12,12,Jordan Lyons,,G,Southern Utah,Big Sky,13,34,1,4,1,4,0,0,3,4,1,3,4,2,0,1,4,3,5
Southern Utah13,13,Joel Swallow,FR,F,Southern Utah,Big Sky,7,23,2,6,2,6,0,0,1,2,2,4,6,0,0,0,1,1,5
Southern Utah14,14,Elijah Graves,SR,F,Southern Utah,Big Sky,4,13,1,3,1,2,0,1,1,3,0,2,2,1,0,0,1,4,3
St. Bonaventure1,1,Matt Mobley,SR,G,St. Bonaventure,A-10,32,1203,180,422,78,156,102,266,130,151,17,142,159,79,37,4,73,80,592
St. Bonaventure2,2,Jaylen Adams,,G,St. Bonaventure,A-10,26,969,149,328,74,164,75,164,143,167,12,81,93,141,40,7,82,75,516
St. Bonaventure3,3,LaDarien Griffin,JR,F,St. Bonaventure,A-10,31,930,100,208,100,203,0,5,70,100,77,125,202,36,19,40,38,81,270
St. Bonaventure4,4,Idris Taqqee,SR,G,St. Bonaventure,A-10,32,893,68,156,62,138,6,18,31,54,59,96,155,50,36,23,23,86,173
St. Bonaventure5,5,Courtney Stockard,JR,F,St. Bonaventure,A-10,29,892,131,267,114,221,17,46,94,124,39,145,184,68,38,12,70,98,373
St. Bonaventure6,6,Amadi Ikpeze,SO,C,St. Bonaventure,A-10,32,454,61,122,61,122,0,0,27,45,36,63,99,6,7,15,16,81,149
St. Bonaventure7,7,Izaiah Brockington,FR,G,St. Bonaventure,A-10,32,382,51,116,29,63,22,53,18,35,7,33,40,28,14,5,14,27,142
St. Bonaventure8,8,Josh Ayeni,SO,F,St. Bonaventure,A-10,24,351,53,120,52,116,1,4,20,32,30,37,67,7,5,3,21,74,127
St. Bonaventure9,9,Nelson Kaputo,JR,G,St. Bonaventure,A-10,31,323,33,79,15,25,18,54,18,19,3,17,20,34,17,0,15,26,102
St. Bonaventure10,10,Tshiefu Ngalakulondi,FR,F,St. Bonaventure,A-10,16,70,16,26,11,15,5,11,3,6,6,14,20,6,6,6,5,9,40
St. Bonaventure11,11,Ndene Gueye,JR,F,St. Bonaventure,A-10,5,17,0,3,0,3,0,0,3,6,3,2,5,0,2,0,2,4,3
St. Bonaventure12,12,Jason Lee,FR,G,St. Bonaventure,A-10,5,11,2,3,0,1,2,2,0,0,0,2,2,0,0,0,0,0,6
St. Bonaventure13,13,Jack Galatio,SO,G,St. Bonaventure,A-10,4,4,0,0,0,0,0,0,0,0,0,0,0,0,0,0,1,0,0
St. Francis (NY)1,1,Rasheem Dunn,SO,G,St. Francis (NY),NEC,30,928,157,403,115,253,42,150,105,136,21,151,172,70,42,1,62,60,461
St. Francis (NY)2,2,Glenn Sanabria,JR,G,St. Francis (NY),NEC,29,872,123,279,57,119,66,160,39,64,29,64,93,89,29,9,31,62,351
St. Francis (NY)3,3,Jalen Jordan,FR,G,St. Francis (NY),NEC,31,855,108,260,44,103,64,157,65,77,16,73,89,30,18,4,35,57,345
St. Francis (NY)4,4,Chauncey Hawkins,FR,G,St. Francis (NY),NEC,31,602,63,180,42,105,21,75,57,77,10,34,44,46,23,5,47,65,204
St. Francis (NY)5,5,Josh Nicholas,FR,G,St. Francis (NY),NEC,31,577,58,148,29,72,29,76,23,38,23,43,66,26,27,11,29,77,168
St. Francis (NY)6,6,Jagos Lasic,SR,F,St. Francis (NY),NEC,31,564,51,117,32,67,19,50,23,27,33,66,99,22,27,5,34,58,144
St. Francis (NY)7,7,Milija Cosic,SO,F,St. Francis (NY),NEC,29,546,78,165,65,131,13,34,38,51,44,42,86,10,10,6,44,79,207
St. Francis (NY)8,8,D.J. Porter,SR,F,St. Francis (NY),NEC,31,519,69,155,59,108,10,47,37,47,45,104,149,32,31,14,29,75,185
St. Francis (NY)9,9,Joshua Nurse,JR,F,St. Francis (NY),NEC,29,274,18,46,18,46,0,0,7,24,24,29,53,17,5,16,26,61,43
St. Francis (NY)10,10,Gunnar Olafsson,SR,G,St. Francis (NY),NEC,18,190,28,48,27,43,1,5,2,4,17,22,39,6,3,0,8,20,59
St. Francis (NY)11,11,Yaradyah Evans,FR,F,St. Francis (NY),NEC,15,121,8,24,5,11,3,13,4,7,2,18,20,4,4,1,13,21,23
St. Francis (NY)12,12,Cori Johnson,SO,C,St. Francis (NY),NEC,15,116,14,39,14,39,0,0,14,26,11,17,28,3,1,9,10,21,42
St. Francis (NY)13,13,Keon Williams,JR,F,St. Francis (NY),NEC,12,112,7,21,4,6,3,15,6,11,0,13,13,2,4,1,4,11,23
St. Francis (NY)14,14,Sam Harris,SR,G,St. Francis (NY),NEC,10,12,0,2,0,1,0,1,0,0,0,0,0,0,1,0,1,0,0
St. Francis (NY)15,15,Bryant Beckford,FR,F,St. Francis (NY),NEC,7,12,2,2,2,2,0,0,1,2,0,2,2,0,0,0,0,1,5
St. John's (NY)1,1,Justin Simon,SO,G,St. John's (NY),Big East,33,1190,151,319,136,283,15,36,84,127,38,196,234,167,82,27,95,90,401
St. John's (NY)2,2,Shamorie Ponds,SO,G,St. John's (NY),Big East,30,1110,225,536,178,350,47,186,150,175,36,115,151,142,70,3,82,53,647
St. John's (NY)3,3,Marvin Clark,JR,F,St. John's (NY),Big East,33,1022,143,312,78,154,65,158,63,74,39,117,156,32,38,5,61,112,414
St. John's (NY)4,4,Tariq Owens,JR,F,St. John's (NY),Big East,33,1001,113,224,101,187,12,37,40,58,52,142,194,17,20,94,42,102,278
St. John's (NY)5,5,Bashir Ahmed,SR,G,St. John's (NY),Big East,33,996,130,319,86,191,44,128,68,111,53,102,155,31,35,11,49,94,372
St. John's (NY)6,6,"Bryan Trimble, Jr.",FR,G,St. John's (NY),Big East,32,555,34,95,8,14,26,81,6,7,4,33,37,13,8,2,5,52,100
St. John's (NY)7,7,Amar Alibegovic,SR,F,St. John's (NY),Big East,27,312,16,59,8,20,8,39,4,7,8,25,33,3,7,10,12,45,44
St. John's (NY)8,8,Kassoum Yakwe,JR,F,St. John's (NY),Big East,24,284,16,35,16,35,0,0,20,28,20,31,51,5,5,19,22,44,52
St. John's (NY)9,9,Marcus LoVett,SO,G,St. John's (NY),Big East,7,229,39,93,24,54,15,39,11,15,2,13,15,12,15,0,13,16,104
St. John's (NY)10,10,Justin Cole,SO,G,St. John's (NY),Big East,6,22,0,5,0,5,0,0,0,0,0,4,4,0,1,0,0,6,0
St. John's (NY)11,11,Jay Camus,,G,St. John's (NY),Big East,2,4,0,2,0,0,0,2,0,0,0,0,0,0,1,0,1,0,0
Stanford1,1,Reid Travis,JR,F,Stanford,Pac-12,33,1118,234,442,217,385,17,57,158,234,96,185,281,45,26,4,69,85,643
Stanford2,2,Daejon Davis,FR,G,Stanford,Pac-12,31,945,111,229,89,174,22,55,88,131,23,110,133,149,38,6,125,77,332
Stanford3,3,Michael Humphrey,SR,F,Stanford,Pac-12,33,845,123,265,99,207,24,58,55,76,51,172,223,23,24,31,49,110,325
Stanford4,4,Oscar Da Silva,FR,F,Stanford,Pac-12,33,803,73,143,46,94,27,49,30,47,50,106,156,39,15,28,52,90,203
Stanford5,5,Dorian Pickens,SR,G,Stanford,Pac-12,23,772,106,246,41,92,65,154,58,75,11,71,82,47,17,3,41,29,335
Stanford6,6,Kezie Okpala,,F,Stanford,Pac-12,21,587,68,173,61,143,7,30,71,105,25,56,81,38,18,13,47,62,214
Stanford7,7,Isaac White,FR,G,Stanford,Pac-12,31,542,56,152,18,40,38,112,30,40,1,39,40,25,6,0,27,22,180
Stanford8,8,Robert Cartwright,JR,G,Stanford,Pac-12,26,480,43,117,25,62,18,55,23,31,7,37,44,62,16,1,28,30,127
Stanford9,9,Josh Sharma,JR,C,Stanford,Pac-12,31,305,45,80,41,67,4,13,17,27,27,47,74,3,6,25,20,68,111
Stanford10,10,Kodye Pugh,FR,F,Stanford,Pac-12,16,106,6,19,5,10,1,9,5,10,5,4,9,6,3,1,11,10,18
Stanford11,11,Blake Pagon,SO,G,Stanford,Pac-12,13,85,0,3,0,0,0,3,0,1,0,12,12,6,1,0,5,8,0
Stanford12,12,Trevor Stanback,SO,F,Stanford,Pac-12,13,52,5,6,5,6,0,0,2,5,6,5,11,2,3,4,3,7,12
Stanford13,13,Rodney Herenton,SO,G,Stanford,Pac-12,6,10,1,2,1,2,0,0,2,2,0,1,1,0,0,0,0,0,4
Stephen F. Austin1,1,T.J. Holyfield,JR,F,Stephen F. Austin,Southland,34,927,163,297,136,231,27,66,88,116,81,138,219,29,40,44,94,96,441
Stephen F. Austin2,2,Kevon Harris,SO,G,Stephen F. Austin,Southland,32,826,155,319,98,187,57,132,101,149,69,104,173,40,29,6,57,54,468
Stephen F. Austin3,3,Shannon Bogues,JR,G,Stephen F. Austin,Southland,34,816,197,386,154,265,43,121,88,109,24,57,81,47,46,6,48,39,525
Stephen F. Austin4,4,Leon Gilmore,SR,F,Stephen F. Austin,Southland,34,785,117,226,109,195,8,31,75,116,43,124,167,44,33,14,55,66,317
Stephen F. Austin5,5,Aaron Augustin,SO,G,Stephen F. Austin,Southland,33,781,43,107,25,58,18,49,34,54,8,59,67,112,51,3,53,73,138
Stephen F. Austin6,6,Ivan Canete,SR,G,Stephen F. Austin,Southland,32,750,99,226,51,111,48,115,54,71,23,70,93,97,49,7,61,102,300
Stephen F. Austin7,7,Ty Charles,SR,G,Stephen F. Austin,Southland,28,652,83,194,62,126,21,68,37,52,35,97,132,46,30,7,38,86,224
Stephen F. Austin8,8,John Comeaux,SO,G,Stephen F. Austin,Southland,34,478,56,119,51,91,5,28,31,51,21,48,69,55,42,2,29,81,148
Stephen F. Austin9,9,Samuli Nieminen,SO,F,Stephen F. Austin,Southland,34,435,31,60,22,41,9,19,20,26,21,30,51,8,10,5,40,74,91
Stephen F. Austin10,10,Nathan Bain,,F,Stephen F. Austin,Southland,23,152,14,28,13,22,1,6,18,26,5,13,18,7,14,6,11,29,47
Stephen F. Austin11,11,Jovan Grujic,JR,C,Stephen F. Austin,Southland,22,133,13,30,13,28,0,2,6,11,8,16,24,1,2,1,19,26,32
Stephen F. Austin12,12,Stefon Fisher,FR,F,Stephen F. Austin,Southland,11,61,11,20,11,20,0,0,6,10,6,7,13,4,1,2,7,14,28
Stephen F. Austin13,13,Cameron Mack,,G,Stephen F. Austin,Southland,1,4,0,0,0,0,0,0,0,0,0,0,0,0,0,0,0,0,0
Stetson1,1,Divine Myles,SR,G,Stetson,A-Sun,31,1076,190,381,156,272,34,109,106,145,24,115,139,130,49,4,49,53,520
Stetson2,2,Angel Rivera,SR,G,Stetson,A-Sun,32,938,74,174,42,92,32,82,67,96,21,91,112,150,27,2,50,83,247
Stetson3,3,Luke Doyle,SR,G,Stetson,A-Sun,32,876,115,287,56,110,59,177,30,38,17,75,92,49,28,7,41,49,319
Stetson4,4,B.J. Glasford,SR,G,Stetson,A-Sun,32,845,138,331,97,207,41,124,38,57,28,97,125,56,44,9,51,75,355
Stetson5,5,Abayomi Iyiola,FR,F,Stetson,A-Sun,32,615,139,268,139,265,0,3,44,65,77,122,199,5,16,21,35,97,322
Stetson6,6,Larry Dennis,SR,F,Stetson,A-Sun,32,478,50,124,50,124,0,0,11,32,21,82,103,7,10,24,41,74,111
Stetson7,7,Christiaan Jones,FR,G,Stetson,A-Sun,31,437,55,139,26,57,29,82,15,26,16,49,65,24,15,5,19,18,154
Stetson8,8,Kenny Aninye,FR,G,Stetson,A-Sun,31,346,30,75,17,41,13,34,9,10,5,22,27,28,13,1,17,38,82
Stetson9,9,Leo Goodman,,G,Stetson,A-Sun,24,342,46,111,21,52,25,59,9,10,18,37,55,10,13,3,14,39,126
Stetson10,10,Keith Matthews,FR,G,Stetson,A-Sun,31,322,46,98,38,68,8,30,16,33,18,49,67,10,12,2,18,35,116
Stetson11,11,Adam Webb,FR,C,Stetson,A-Sun,13,76,8,20,8,20,0,0,0,0,6,11,17,0,0,8,6,18,16
Stetson12,12,Raine McKeython,FR,G,Stetson,A-Sun,13,75,11,35,6,18,5,17,0,0,2,7,9,2,0,1,5,6,27
Stetson13,13,Brady Moses,SR,G,Stetson,A-Sun,6,13,3,5,0,0,3,5,2,2,1,2,3,0,0,0,1,1,11
Stetson14,14,Matthew Cioce,SR,G,Stetson,A-Sun,5,11,2,5,1,1,1,4,1,4,1,1,2,0,1,0,0,0,6
Stony Brook1,1,Akwasi Yeboah,SO,G,Stony Brook,AEC,32,913,155,344,96,178,59,166,118,147,29,132,161,44,28,7,74,81,487
Stony Brook2,2,UC Iroegbu,SR,G,Stony Brook,AEC,32,799,82,216,34,88,48,128,48,67,24,54,78,49,38,6,33,62,260
Stony Brook3,3,Tyrell Sturdivant,SR,F,Stony Brook,AEC,32,719,81,212,52,109,29,103,43,78,41,105,146,56,52,13,63,88,234
Stony Brook4,4,Elijah Olaniyi,FR,F,Stony Brook,AEC,32,713,96,210,70,128,26,82,31,58,39,84,123,21,32,4,48,62,249
Stony Brook5,5,Junior Saintel,SR,G,Stony Brook,AEC,32,685,88,196,82,171,6,25,45,68,51,99,150,19,29,24,44,67,227
Stony Brook6,6,Bryan Sekunda,SR,G,Stony Brook,AEC,28,623,50,138,11,34,39,104,9,11,16,40,56,51,7,5,13,39,148
Stony Brook7,7,Jaron Cornish,JR,G,Stony Brook,AEC,27,596,84,210,62,134,22,76,42,65,18,82,100,77,26,14,75,72,232
Stony Brook8,8,Jordan McKenzie,FR,G,Stony Brook,AEC,28,466,37,100,30,59,7,41,10,14,4,31,35,64,17,2,30,51,91
Stony Brook9,9,Jakub Petras,SR,F,Stony Brook,AEC,32,429,60,114,59,113,1,1,28,50,43,40,83,15,13,14,24,54,149
Stony Brook10,10,Anthony Ochefu,FR,F,Stony Brook,AEC,22,184,18,46,18,45,0,1,7,19,16,31,47,3,6,4,16,26,43
Stony Brook11,11,Michael Almonacy,SO,G,Stony Brook,AEC,20,184,14,42,5,20,9,22,11,12,8,26,34,23,9,0,9,25,48
Stony Brook12,12,Andrew Garcia,,G,Stony Brook,AEC,11,111,12,34,10,28,2,6,6,16,15,9,24,3,2,1,14,16,32
Stony Brook13,13,Corry Long,FR,G,Stony Brook,AEC,6,22,2,3,1,1,1,2,0,1,0,1,1,2,2,0,1,3,5
Stony Brook14,14,Tim Donohoe,SR,G,Stony Brook,AEC,3,6,0,1,0,1,0,0,0,0,0,0,0,0,0,0,0,1,0
Syracuse1,1,Tyus Battle,SO,G,Syracuse,ACC,33,1281,214,530,144,313,70,217,156,185,15,86,101,63,52,7,77,67,654
Syracuse2,2,Franklin Howard,JR,G,Syracuse,ACC,33,1265,174,457,110,265,64,192,83,118,17,94,111,164,62,9,117,82,495
Syracuse3,3,Oshae Brissett,FR,F,Syracuse,ACC,33,1254,141,401,90,253,51,148,152,190,72,218,290,31,38,24,61,76,485
Syracuse4,4,Paschal Chukwu,JR,C,Syracuse,ACC,33,902,67,101,67,101,0,0,45,72,97,128,225,15,25,89,39,101,179
Syracuse5,5,Marek Dolezaj,FR,F,Syracuse,ACC,33,894,61,117,60,109,1,8,50,70,65,94,159,52,28,25,43,87,173
Syracuse6,6,Matthew Moyer,SO,F,Syracuse,ACC,31,556,44,81,43,72,1,9,20,36,36,79,115,15,11,9,22,49,109
Syracuse7,7,Bourama Sidibe,FR,F,Syracuse,ACC,26,330,28,49,28,49,0,0,17,36,32,54,86,4,10,19,23,60,73
Syracuse8,8,Howard Washington,FR,G,Syracuse,ACC,18,111,5,17,3,5,2,12,7,10,0,15,15,10,6,1,7,5,19
Syracuse9,9,Geno Thorpe,SR,G,Syracuse,ACC,6,86,14,38,10,24,4,14,4,5,2,3,5,6,6,0,7,7,36
Syracuse10,10,Braedon Bayer,JR,G,Syracuse,ACC,8,11,1,1,1,1,0,0,0,0,0,4,4,0,0,0,1,3,2
Syracuse11,11,Patrick Herlihy,SR,F,Syracuse,ACC,4,4,1,2,1,2,0,0,0,0,0,1,1,0,0,0,0,1,2
Syracuse12,12,Ray Featherston,SO,G,Syracuse,ACC,3,2,0,0,0,0,0,0,0,0,0,0,0,1,0,0,0,0,0
Syracuse13,13,Adrian Autry,JR,G,Syracuse,ACC,3,2,0,1,0,0,0,1,0,0,0,0,0,0,0,0,0,0,0
Syracuse14,14,Shaun Belbey,JR,G,Syracuse,ACC,3,2,1,1,1,1,0,0,0,0,0,0,0,1,1,0,0,0,2
Temple1,1,Levan Shawn Alston,JR,G,Temple,AAC,32,1076,151,378,82,206,69,172,52,57,22,81,103,98,25,1,51,50,423
Temple2,2,Josh Brown,SR,G,Temple,AAC,32,1056,105,254,74,176,31,78,46,64,23,98,121,107,27,10,55,68,287
Temple3,3,Quinton Rose,SO,G,Temple,AAC,32,1026,185,423,137,284,48,139,64,96,22,114,136,71,48,4,79,55,482
Temple4,4,Obi Enechionyia,SR,F,Temple,AAC,31,929,107,279,51,121,56,158,68,83,52,129,181,37,16,44,42,82,338
Temple5,5,Ernest Aflakpui,JR,C,Temple,AAC,32,605,62,98,62,98,0,0,21,41,44,83,127,18,14,10,30,104,145
Temple6,6,Nate Pierre-Louis,,G,Temple,AAC,26,442,75,160,56,105,19,55,33,55,30,50,80,15,23,8,20,31,202
Temple7,7,De'Vondre Perry,,F,Temple,AAC,30,357,33,85,19,36,14,49,12,19,14,40,54,13,12,12,14,65,92
Temple8,8,Alani Moore,SO,G,Temple,AAC,27,350,29,91,14,32,15,59,10,18,11,19,30,26,25,1,14,26,83
Temple9,9,J.P. Moorman,FR,F,Temple,AAC,26,318,34,81,21,42,13,39,19,25,25,65,90,19,17,4,16,43,100
Temple10,10,Damion Moore,SO,C,Temple,AAC,25,245,37,66,37,66,0,0,15,33,24,25,49,2,5,6,11,27,89
Temple11,11,Justyn Hamilton,,F,Temple,AAC,11,28,1,9,1,9,0,0,1,2,1,3,4,2,2,2,0,5,3
Temple12,12,Steve Leonard,,G,Temple,AAC,5,10,2,4,0,1,2,3,1,2,0,2,2,0,0,1,1,0,7
Temple13,13,Ayan Nunez de Carvalho,,G,Temple,AAC,7,9,0,3,0,0,0,3,0,0,0,1,1,0,0,0,1,0,0
Tennessee1,1,Grant Williams,SO,F,Tennessee,SEC,32,913,167,359,164,334,3,25,153,201,67,123,190,59,17,42,67,106,490
Tennessee2,2,Admiral Schofield,JR,F,Tennessee,SEC,32,893,159,356,105,218,54,138,63,84,50,149,199,50,32,12,56,93,435
Tennessee3,3,Jordan Bowden,SO,G,Tennessee,SEC,32,883,92,229,43,110,49,119,71,95,31,82,113,61,35,11,37,78,304
Tennessee4,4,Lamonte Turner,SO,G,Tennessee,SEC,32,792,107,262,43,104,64,158,64,73,18,88,106,65,23,2,42,64,342
Tennessee5,5,Jordan Bone,SO,G,Tennessee,SEC,32,735,80,206,57,143,23,63,45,54,8,62,70,115,22,2,43,35,228
Tennessee6,6,James Daniel,SR,G,Tennessee,SEC,32,654,57,152,14,40,43,112,30,42,12,33,45,93,27,4,48,63,187
Tennessee7,7,Kyle Alexander,JR,F,Tennessee,SEC,32,649,72,105,71,104,1,1,34,47,78,103,181,11,18,53,23,78,179
Tennessee8,8,Derrick Walker,FR,F,Tennessee,SEC,31,277,26,44,26,44,0,0,10,25,28,44,72,8,3,7,21,42,62
Tennessee9,9,John Fulkerson,FR,F,Tennessee,SEC,27,247,17,40,17,40,0,0,16,22,14,23,37,15,16,8,17,32,50
Tennessee10,10,Chris Darrington,JR,G,Tennessee,SEC,24,208,19,52,13,33,6,19,20,26,3,12,15,19,7,0,14,17,64
Tennessee11,11,Yves Pons,FR,F,Tennessee,SEC,21,104,6,11,4,8,2,3,1,2,3,9,12,5,3,2,3,15,15
Tennessee12,12,Jalen Johnson,FR,G,Tennessee,SEC,12,64,5,10,2,4,3,6,1,2,3,6,9,5,1,2,2,0,14
Tennessee13,13,Zach Kent,FR,F,Tennessee,SEC,2,13,2,6,2,5,0,1,0,0,1,2,3,0,0,0,0,1,4
Tennessee14,14,Lucas Campbell,JR,G,Tennessee,SEC,3,7,1,1,0,0,1,1,0,0,0,1,1,2,0,0,0,0,3
Tennessee15,15,Brad Woodson,JR,G,Tennessee,SEC,2,6,0,2,0,0,0,2,0,0,0,0,0,0,0,0,0,1,0
Tennessee16,16,Jacob Fleschman,FR,G,Tennessee,SEC,2,5,0,0,0,0,0,0,0,0,0,0,0,0,0,0,0,0,0
Tennessee State1,1,Delano Spencer,SR,G,Tennessee State,OVC,30,984,152,348,67,147,85,201,75,90,17,76,93,38,34,2,55,56,464
Tennessee State2,2,Christian Mekowulu,JR,F,Tennessee State,OVC,30,873,121,233,119,228,2,5,137,184,73,164,237,26,27,46,73,95,381
Tennessee State3,3,Armani Chaney,JR,G,Tennessee State,OVC,30,870,82,222,53,126,29,96,42,58,18,75,93,111,43,2,84,72,235
Tennessee State4,4,Darreon Reddick,SR,G,Tennessee State,OVC,30,848,65,193,37,99,28,94,63,87,12,78,90,50,25,5,57,48,221
Tennessee State5,5,Kamar McKnight,SO,G,Tennessee State,OVC,30,657,90,214,60,123,30,91,44,62,8,63,71,47,23,0,46,52,254
Tennessee State6,6,Ken'Darrius Hamilton,,F,Tennessee State,OVC,28,655,89,195,60,99,29,96,32,36,26,91,117,22,18,15,57,99,239
Tennessee State7,7,Stokley Chaffee,JR,F,Tennessee State,OVC,28,476,33,50,32,48,1,2,21,39,41,67,108,8,21,11,16,51,88
Tennessee State8,8,Daniel Cummings,FR,G,Tennessee State,OVC,22,188,10,29,1,6,9,23,5,6,6,15,21,4,1,0,8,29,34
Tennessee State9,9,Tripp Davis,,G,Tennessee State,OVC,18,132,3,16,3,9,0,7,11,16,3,18,21,10,13,1,8,20,17
Tennessee State10,10,Jalen Duke,SO,G,Tennessee State,OVC,17,122,11,20,8,12,3,8,4,8,2,7,9,2,2,3,6,15,29
Tennessee State11,11,Samson Oyediran,JR,F,Tennessee State,OVC,18,122,4,7,4,6,0,1,0,2,6,13,19,3,2,0,4,14,8
Tennessee State12,12,A.C. Reid,SR,G,Tennessee State,OVC,10,102,4,28,0,0,4,28,0,0,0,7,7,4,2,1,3,7,12
Tennessee State13,13,Hampus Ahlin,JR,F,Tennessee State,OVC,10,71,5,19,2,7,3,12,2,2,1,7,8,1,2,0,7,5,15
Tennessee Tech1,1,Kajon Mack,SR,G,Tennessee Tech,OVC,32,1107,132,319,94,199,38,120,105,136,38,125,163,126,33,12,60,77,407
Tennessee Tech2,2,Curtis Phillips,SR,F,Tennessee Tech,OVC,33,1011,152,387,91,208,61,179,107,149,34,137,171,72,59,19,99,69,472
Tennessee Tech3,3,Mason Ramsey,SR,F,Tennessee Tech,OVC,33,897,135,270,130,245,5,25,68,91,62,73,135,41,34,11,49,119,343
Tennessee Tech4,4,Courtney Alexander II,JR,F,Tennessee Tech,OVC,33,873,79,171,79,170,0,1,66,128,72,190,262,56,29,27,76,83,224
Tennessee Tech5,5,Shaq Calhoun,SR,G,Tennessee Tech,OVC,33,805,122,284,63,130,59,154,53,66,13,82,95,41,38,13,41,97,356
Tennessee Tech6,6,Aleksa Jugovic,SR,G,Tennessee Tech,OVC,23,685,95,208,49,97,46,111,48,56,4,40,44,71,22,3,48,25,284
Tennessee Tech7,7,Micaiah Henry,SO,C,Tennessee Tech,OVC,32,459,59,96,59,96,0,0,16,50,32,55,87,11,6,20,42,87,134
Tennessee Tech8,8,Cade Crosland,SO,G,Tennessee Tech,OVC,29,247,25,57,7,10,18,47,3,7,11,16,27,20,7,0,11,19,71
Tennessee Tech9,9,Corey Tillery,SO,G,Tennessee Tech,OVC,18,191,12,50,5,17,7,33,2,2,2,9,11,5,5,0,6,17,33
Tennessee Tech10,10,Joan Duran,JR,F,Tennessee Tech,OVC,20,157,19,42,13,28,6,14,4,9,10,21,31,8,8,2,9,24,48
Tennessee Tech11,11,Stephaun Adams,JR,G,Tennessee Tech,OVC,9,121,5,22,4,14,1,8,9,14,4,17,21,18,8,0,9,18,20
Tennessee Tech12,12,Domen Omladic,FR,F,Tennessee Tech,OVC,12,46,7,13,7,11,0,2,0,0,3,7,10,1,1,0,4,14,14
Tennessee Tech13,13,Maverick Smith,FR,G,Tennessee Tech,OVC,8,26,2,5,1,2,1,3,2,2,0,2,2,1,2,0,0,0,7
Tennessee-Martin1,1,Matthew Butler,SR,G,Tennessee-Martin,OVC,31,1169,180,450,90,192,90,258,47,56,10,71,81,92,29,2,100,62,497
Tennessee-Martin2,2,Fatodd Lewis,JR,F,Tennessee-Martin,OVC,30,875,143,317,121,234,22,83,63,88,63,157,220,40,31,17,61,74,371
Tennessee-Martin3,3,DelFincko Bogan,JR,G,Tennessee-Martin,OVC,31,845,110,227,69,125,41,102,28,35,12,73,85,93,58,4,61,71,289
Tennessee-Martin4,4,Darius Thompson,SR,G,Tennessee-Martin,OVC,31,739,64,167,40,90,24,77,54,64,6,58,64,45,30,15,40,68,206
Tennessee-Martin5,5,Terrence Parker,JR,C,Tennessee-Martin,OVC,31,524,60,108,60,108,0,0,28,46,48,102,150,18,14,15,46,79,148
Tennessee-Martin6,6,Dominique Williams,SR,F,Tennessee-Martin,OVC,29,502,61,132,54,103,7,29,28,43,32,65,97,22,7,7,27,42,157
Tennessee-Martin7,7,Mike Fofana,SO,F,Tennessee-Martin,OVC,30,484,35,91,35,82,0,9,12,22,26,69,95,31,10,8,30,35,82
Tennessee-Martin8,8,Jailen Gill,JR,F,Tennessee-Martin,OVC,30,460,74,122,74,122,0,0,19,31,44,74,118,13,13,29,37,73,167
Tennessee-Martin9,9,Parrish Hewitt,FR,G,Tennessee-Martin,OVC,29,389,51,112,37,62,14,50,19,25,9,42,51,23,10,6,14,29,135
Tennessee-Martin10,10,Kahari Beaufort,SR,G,Tennessee-Martin,OVC,14,165,19,47,15,29,4,18,6,8,7,11,18,10,8,2,11,23,48
Tennessee-Martin11,11,Lorenzen Wright Jr.,,G,Tennessee-Martin,OVC,18,82,9,27,1,3,8,24,2,3,2,8,10,2,3,0,3,5,28
Tennessee-Martin12,12,Julian Thompson-Clay,,F,Tennessee-Martin,OVC,3,20,0,1,0,1,0,0,0,1,3,2,5,0,1,0,1,2,0
Tennessee-Martin13,13,Jerome Davis,JR,F,Tennessee-Martin,OVC,7,20,2,4,2,4,0,0,3,4,1,3,4,1,0,0,2,5,7
Tennessee-Martin14,14,Dalen Victor,,C,Tennessee-Martin,OVC,1,1,0,0,0,0,0,0,0,0,0,0,0,0,0,0,1,0,0
Texas1,1,Dylan Osetkowski,JR,F,Texas,Big 12,33,1153,159,393,117,248,42,145,90,121,76,157,233,38,33,7,72,62,450
Texas2,2,Matt Coleman,FR,G,Texas,Big 12,33,1113,114,286,90,193,24,93,67,85,24,59,83,136,40,1,72,100,319
Texas3,3,Kerwin Roach Jr.,JR,G,Texas,Big 12,31,1025,132,303,94,191,38,112,69,106,24,90,114,111,46,8,78,79,371
Texas4,4,Mohamed Bamba,FR,F,Texas,Big 12,29,875,140,259,126,209,14,50,80,118,92,210,302,14,22,106,46,71,374
Texas5,5,Eric Davis Jr.,JR,G,Texas,Big 12,26,680,75,189,35,74,40,115,38,51,6,57,63,16,17,0,24,47,228
Texas6,6,Jericho Sims,FR,F,Texas,Big 12,33,612,69,114,69,113,0,1,29,68,38,91,129,6,11,18,26,58,167
Texas7,7,Jase Febres,FR,G,Texas,Big 12,30,482,36,117,8,25,28,92,6,8,21,33,54,17,7,7,11,41,106
Texas8,8,Jacob Young,SO,G,Texas,Big 12,29,463,68,163,39,76,29,87,14,20,6,43,49,22,20,1,18,28,179
Texas9,9,Andrew Jones,SO,G,Texas,Big 12,10,226,47,89,28,49,19,40,22,30,4,20,24,20,6,2,17,16,135
Texas10,10,James Banks,SO,C,Texas,Big 12,14,95,8,14,8,14,0,0,7,18,10,14,24,0,1,11,3,18,23
Texas11,11,Royce Hamm Jr.,FR,F,Texas,Big 12,17,90,2,11,2,7,0,4,7,15,8,15,23,0,2,2,8,9,11
Texas12,12,Ryan McClurg,SR,F,Texas,Big 12,4,6,1,2,1,2,0,0,2,4,0,1,1,0,0,0,1,0,4
Texas13,13,Joe Schwartz,SR,G,Texas,Big 12,4,5,0,3,0,0,0,3,0,1,0,0,0,1,0,0,0,2,0
Texas A&M1,1,Tyler Davis,JR,C,Texas A&M,SEC,32,923,182,316,175,291,7,25,93,144,111,170,281,43,11,42,64,84,464
Texas A&M2,2,DJ Hogg,JR,F,Texas A&M,SEC,29,897,110,264,50,108,60,156,48,67,32,118,150,75,24,25,47,61,328
Texas A&M3,3,Admon Gilder,JR,G,Texas A&M,SEC,27,852,111,245,67,135,44,110,64,78,17,97,114,69,36,4,46,57,330
Texas A&M4,4,Tonny Trocha-Morelos,SR,C,Texas A&M,SEC,32,715,79,191,56,116,23,75,40,68,51,94,145,37,15,32,33,73,221
Texas A&M5,5,Robert Williams,SO,F,Texas A&M,SEC,27,695,124,200,124,188,0,12,30,64,66,178,244,38,22,68,46,59,278
Texas A&M6,6,TJ Starks,FR,G,Texas A&M,SEC,29,589,104,266,74,173,30,93,39,61,8,51,59,58,12,2,69,51,277
Texas A&M7,7,Duane Wilson,SR,G,Texas A&M,SEC,22,528,68,175,48,107,20,68,41,52,2,44,46,89,25,5,51,39,197
Texas A&M8,8,Savion Flagg,FR,G,Texas A&M,SEC,27,430,43,100,31,62,12,38,18,32,37,61,98,20,8,2,21,34,116
Texas A&M9,9,Jay Jay Chandler,FR,G,Texas A&M,SEC,30,339,38,105,30,66,8,39,26,34,15,17,32,22,8,1,23,39,110
Texas A&M10,10,JJ Caldwell,,G,Texas A&M,SEC,16,256,16,42,14,35,2,7,13,18,8,23,31,41,12,2,21,20,47
Texas A&M11,11,Chris Collins,JR,G,Texas A&M,SEC,15,118,9,28,4,10,5,18,3,4,3,13,16,2,5,1,3,13,26
Texas A&M12,12,Isiah Jasey,FR,F,Texas A&M,SEC,13,48,3,6,3,5,0,1,0,0,2,5,7,0,1,4,3,4,6
Texas A&M13,13,Mark French,SO,G,Texas A&M,SEC,3,5,0,3,0,1,0,2,0,0,0,0,0,0,0,0,0,2,0
Texas A&M14,14,Frank Byers,JR,G,Texas A&M,SEC,3,5,0,1,0,0,0,1,0,0,1,0,1,0,0,0,0,0,0
Texas A&M15,15,Cameron Alo,,G,Texas A&M,SEC,2,1,0,0,0,0,0,0,0,0,0,0,0,1,1,0,0,0,0
Texas A&M-Corpus Christi1,1,Joe Kilgore,SR,G,Texas A&M-Corpus Christi,Southland,29,1019,183,451,146,343,37,108,137,173,28,135,163,96,52,17,86,60,540
Texas A&M-Corpus Christi2,2,Kareem South,SO,G,Texas A&M-Corpus Christi,Southland,29,893,118,277,78,169,40,108,55,64,33,92,125,34,29,3,50,63,331
Texas A&M-Corpus Christi3,3,Sean Rhea,FR,F,Texas A&M-Corpus Christi,Southland,26,671,91,180,88,172,3,8,60,104,47,95,142,13,21,20,54,90,245
Texas A&M-Corpus Christi4,4,Elijah Schmidt,FR,F,Texas A&M-Corpus Christi,Southland,29,638,57,113,55,100,2,13,31,52,47,111,158,23,18,8,32,84,147
Texas A&M-Corpus Christi5,5,Myles Smith,FR,G,Texas A&M-Corpus Christi,Southland,26,636,67,149,47,93,20,56,49,61,14,53,67,50,19,1,52,71,203
Texas A&M-Corpus Christi6,6,Colin Hale,SO,G,Texas A&M-Corpus Christi,Southland,29,457,34,88,25,51,9,37,2,6,9,39,48,27,15,1,35,35,79
Texas A&M-Corpus Christi7,7,Perry Francois,SO,F,Texas A&M-Corpus Christi,Southland,29,337,35,71,35,71,0,0,10,18,32,46,78,14,2,18,32,63,80
Texas A&M-Corpus Christi8,8,Tre Gray,FR,G,Texas A&M-Corpus Christi,Southland,24,249,39,88,20,38,19,50,27,38,1,11,12,9,9,0,20,33,124
Texas A&M-Corpus Christi9,9,Deion Rhea,,F,Texas A&M-Corpus Christi,Southland,12,225,26,63,19,41,7,22,18,27,9,30,39,5,4,10,22,28,77
Texas A&M-Corpus Christi10,10,Kyle Brown,SO,G,Texas A&M-Corpus Christi,Southland,22,175,8,21,6,19,2,2,6,13,1,10,11,17,13,0,16,20,24
Texas A&M-Corpus Christi11,11,York Benjamin,FR,F,Texas A&M-Corpus Christi,Southland,15,162,11,25,11,24,0,1,15,17,16,21,37,5,5,2,31,26,37
Texas A&M-Corpus Christi12,12,Emmanuel Toney,SR,G,Texas A&M-Corpus Christi,Southland,6,157,16,33,8,16,8,17,3,6,3,11,14,16,5,2,12,11,43
Texas A&M-Corpus Christi13,13,David Bloom,SR,G,Texas A&M-Corpus Christi,Southland,20,143,2,14,1,6,1,8,12,15,3,8,11,11,2,2,7,12,17
Texas A&M-Corpus Christi14,14,Jamell Bradley,FR,G,Texas A&M-Corpus Christi,Southland,14,49,3,10,2,7,1,3,4,5,2,8,10,1,1,0,2,7,11
Texas A&M-Corpus Christi15,15,Peyton Smith,,G,Texas A&M-Corpus Christi,Southland,9,39,1,6,1,2,0,4,3,4,1,4,5,2,2,0,2,3,5
Texas Christian1,1,Kenrich Williams,SR,G,Texas Christian,Big 12,31,1118,148,310,103,200,45,110,66,95,86,203,289,123,56,15,63,78,407
Texas Christian2,2,Desmond Bane,SO,G,Texas Christian,Big 12,32,968,143,262,85,139,58,123,64,82,15,115,130,78,30,7,55,73,408
Texas Christian3,3,Alex Robinson,JR,G,Texas Christian,Big 12,30,954,109,244,86,178,23,66,52,90,13,74,87,182,34,8,98,67,293
Texas Christian4,4,Vladimir Brodziansky,SR,F,Texas Christian,Big 12,32,868,174,302,153,240,21,62,114,139,67,95,162,37,10,52,41,70,483
Texas Christian5,5,Kouat Noi,FR,F,Texas Christian,Big 12,32,701,116,233,59,100,57,133,39,64,36,90,126,24,21,3,26,58,328
Texas Christian6,6,JD Miller,JR,F,Texas Christian,Big 12,32,640,101,213,82,152,19,61,37,56,42,84,126,33,20,18,36,45,258
Texas Christian7,7,Jaylen Fisher,SO,G,Texas Christian,Big 12,17,465,74,147,45,81,29,66,32,38,6,20,26,91,19,1,34,36,209
Texas Christian8,8,Ahmed Hamdy Mohamed,SR,F,Texas Christian,Big 12,31,411,70,138,70,138,0,0,47,71,37,53,90,7,8,9,27,69,187
Texas Christian9,9,Shawn Olden,JR,G,Texas Christian,Big 12,28,330,19,53,2,8,17,45,6,8,3,19,22,21,12,1,12,35,61
Texas Christian10,10,RJ Nembhard,FR,G,Texas Christian,Big 12,6,33,4,14,4,9,0,5,1,4,2,4,6,5,0,1,5,2,9
Texas Christian11,11,Dalton Dry,SR,G,Texas Christian,Big 12,8,23,2,7,0,2,2,5,7,10,0,4,4,0,1,0,0,2,13
Texas Christian12,12,Clayton Crawford,SR,F,Texas Christian,Big 12,6,12,0,1,0,0,0,1,0,0,0,1,1,0,0,0,0,2,0
Texas Christian13,13,Austin Sottile,,F,Texas Christian,Big 12,2,2,0,1,0,1,0,0,0,0,0,0,0,0,0,0,0,0,0
Texas Southern1,1,Donte Clark,SR,G,Texas Southern,SWAC,34,1187,196,483,155,341,41,142,201,263,38,141,179,90,38,12,94,105,634
Texas Southern2,2,Derrick Bruce,JR,G,Texas Southern,SWAC,30,979,134,337,55,141,79,196,70,84,17,98,115,61,34,8,67,67,417
Texas Southern3,3,Demontrae Jefferson,SO,G,Texas Southern,SWAC,25,937,192,453,112,250,80,203,120,148,15,59,74,113,29,0,78,62,584
Texas Southern4,4,Trayvon Reed,JR,C,Texas Southern,SWAC,28,776,104,154,103,145,1,9,63,96,71,175,246,10,12,82,37,87,272
Texas Southern5,5,Marquis Salmon,SR,F,Texas Southern,SWAC,34,685,72,119,71,116,1,3,34,60,79,133,212,10,15,18,30,91,179
Texas Southern6,6,Lamont Walker,SR,F,Texas Southern,SWAC,27,532,50,105,38,76,12,29,41,64,34,86,120,14,15,2,13,49,153
Texas Southern7,7,Brian Carey,SO,G,Texas Southern,SWAC,29,509,26,71,17,45,9,26,24,38,5,34,39,45,17,0,42,39,85
Texas Southern8,8,Cainan McClelland,FR,G,Texas Southern,SWAC,30,398,23,66,7,21,16,45,17,24,4,26,30,19,7,0,15,22,79
Texas Southern9,9,Robert Lewis,JR,G,Texas Southern,SWAC,14,263,27,65,13,30,14,35,11,20,1,25,26,9,3,2,10,22,79
Texas Southern10,10,Kevin Scott,SR,F,Texas Southern,SWAC,7,232,32,85,22,50,10,35,14,18,8,20,28,21,9,5,15,23,88
Texas Southern11,11,Jerry Perry,,G,Texas Southern,SWAC,11,202,10,28,7,20,3,8,19,26,6,9,15,19,6,0,16,15,42
Texas Southern12,12,Kevin Granger,,F,Texas Southern,SWAC,14,105,11,19,11,19,0,0,3,16,8,19,27,2,2,4,4,13,25
Texas Southern13,13,Divonte Lumpkin,SO,G,Texas Southern,SWAC,9,43,1,3,1,3,0,0,1,3,0,4,4,3,2,0,3,4,3
Texas Southern14,14,Aaron Campbell,,F,Texas Southern,SWAC,2,3,0,1,0,0,0,1,0,0,0,0,0,1,1,0,0,0,0
Texas State1,1,Nijal Pearson,SO,G,Texas State,Sun Belt,33,1077,172,437,114,261,58,176,100,141,67,130,197,80,44,13,80,75,502
Texas State2,2,Tre'Larenz Nottingham,,G,Texas State,Sun Belt,33,816,75,231,29,90,46,141,52,70,5,72,77,88,25,5,63,61,248
Texas State3,3,Alex Peacock,JR,F,Texas State,Sun Belt,33,811,81,160,59,95,22,65,51,70,51,113,164,61,33,10,50,70,235
Texas State4,4,Tyler Blount,SR,G,Texas State,Sun Belt,33,768,84,199,33,74,51,125,12,22,10,52,62,37,11,1,24,38,231
Texas State5,5,Immanuel King,SR,F,Texas State,Sun Belt,33,756,122,211,122,211,0,0,50,96,71,122,193,29,14,26,41,70,294
Texas State6,6,Eric Terry,SO,F,Texas State,Sun Belt,33,519,67,113,67,113,0,0,57,78,37,53,90,20,6,20,54,79,191
Texas State7,7,Nedeljko Prijovic,SO,F,Texas State,Sun Belt,30,490,50,110,41,78,9,32,15,24,30,72,102,25,4,11,20,43,124
Texas State8,8,Marlin Davis,SO,G,Texas State,Sun Belt,16,429,28,70,26,56,2,14,15,31,3,30,33,56,13,1,30,29,73
Texas State9,9,Shelby Adams,FR,G,Texas State,Sun Belt,31,339,37,83,31,59,6,24,27,45,9,30,39,13,14,1,14,24,107
Texas State10,10,Isaiah Gurley,JR,G,Texas State,Sun Belt,22,250,24,72,15,39,9,33,20,27,4,26,30,14,7,2,12,19,77
Texas State11,11,Deris Duncan,SR,G,Texas State,Sun Belt,29,202,18,45,11,24,7,21,14,17,11,22,33,8,3,1,13,12,57
Texas State12,12,Reggie Miller,FR,G,Texas State,Sun Belt,18,129,9,28,5,16,4,12,10,12,4,13,17,16,3,0,13,13,32
Texas State13,13,Quentin Scott,FR,F,Texas State,Sun Belt,13,64,6,23,6,18,0,5,7,18,9,10,19,1,2,1,2,10,19
Texas Tech1,1,Keenan Evans,SR,G,Texas Tech,Big 12,32,930,174,365,131,228,43,137,169,209,10,87,97,98,38,10,60,58,560
Texas Tech2,2,Zhaire Smith,FR,G,Texas Tech,Big 12,33,921,134,239,121,208,13,31,86,119,71,81,152,54,39,34,38,56,367
Texas Tech3,3,Jarrett Culver,FR,G,Texas Tech,Big 12,33,874,133,283,80,153,53,130,66,104,35,121,156,56,41,24,49,66,385
Texas Tech4,4,Justin Gray,SR,G,Texas Tech,Big 12,32,668,57,124,51,102,6,22,41,49,34,76,110,35,27,18,23,77,161
Texas Tech5,5,Niem Stevenson,SR,G,Texas Tech,Big 12,33,667,83,205,52,130,31,75,52,75,26,76,102,58,16,6,36,46,249
Texas Tech6,6,Brandone Francis,JR,G,Texas Tech,Big 12,33,519,67,147,36,68,31,79,11,24,15,51,66,23,13,1,23,49,176
Texas Tech7,7,Norense Odiase,JR,C,Texas Tech,Big 12,33,516,49,93,49,93,0,0,38,63,63,93,156,23,19,16,41,89,136
Texas Tech8,8,Tommy Hamilton,SR,F,Texas Tech,Big 12,33,495,72,172,43,99,29,73,18,30,28,78,106,26,13,6,47,60,191
Texas Tech9,9,Davide Moretti,FR,G,Texas Tech,Big 12,33,406,33,102,10,29,23,73,20,24,5,23,28,32,16,0,28,43,109
Texas Tech10,10,Zach Smith,SR,F,Texas Tech,Big 12,19,391,49,86,48,82,1,4,15,36,20,52,72,20,14,17,28,32,114
Texas Tech11,11,Josh Webster,JR,G,Texas Tech,Big 12,24,145,3,21,3,16,0,5,2,6,3,14,17,17,5,0,6,7,8
Texas Tech12,12,Malik Ondigo,FR,F,Texas Tech,Big 12,13,75,6,13,6,13,0,0,3,4,4,8,12,0,2,1,9,11,15
Texas Tech13,13,Andrew Sorrells,SO,G,Texas Tech,Big 12,10,24,1,6,0,3,1,3,2,2,0,4,4,4,2,0,2,1,5
Texas Tech14,14,Parker Hicks,FR,G,Texas Tech,Big 12,9,19,2,3,1,1,1,2,2,4,0,1,1,1,0,1,1,4,7
Texas-Arlington1,1,Erick Neal,SR,G,Texas-Arlington,Sun Belt,32,1102,186,417,94,185,92,232,76,99,24,110,134,219,64,3,121,77,540
Texas-Arlington2,2,Kevin Hervey,SR,F,Texas-Arlington,Sun Belt,32,1028,241,532,166,313,75,219,108,135,76,201,277,73,41,18,87,60,665
Texas-Arlington3,3,Kaelon Wilson,SR,G,Texas-Arlington,Sun Belt,31,940,113,283,71,189,42,94,88,135,41,89,130,61,17,2,55,69,356
Texas-Arlington4,4,Nathan Hawkins,SR,G,Texas-Arlington,Sun Belt,32,912,79,213,52,113,27,100,19,36,14,69,83,67,39,3,55,88,204
Texas-Arlington5,5,Johnny Hamilton,SR,C,Texas-Arlington,Sun Belt,33,761,138,222,138,221,0,1,80,123,90,170,260,19,17,74,63,94,356
Texas-Arlington6,6,DJ Bryant,SO,G,Texas-Arlington,Sun Belt,33,478,22,52,12,21,10,31,10,18,6,41,47,57,22,1,24,41,64
Texas-Arlington7,7,Davion Turner,JR,G,Texas-Arlington,Sun Belt,30,448,52,108,22,40,30,68,27,37,23,63,86,18,7,15,22,37,161
Texas-Arlington8,8,Mairega Clarke,SR,G,Texas-Arlington,Sun Belt,28,333,16,47,9,27,7,20,15,22,5,27,32,11,10,9,22,36,54
Texas-Arlington9,9,Julian Harris,SR,F,Texas-Arlington,Sun Belt,22,315,26,56,26,54,0,2,32,46,14,44,58,7,6,6,25,44,84
Texas-Arlington10,10,Link Kabadyundi,SR,C,Texas-Arlington,Sun Belt,25,258,30,40,30,40,0,0,14,34,19,50,69,3,5,7,15,50,74
Texas-Arlington11,11,Scott Muirhead,SO,F,Texas-Arlington,Sun Belt,18,50,7,27,0,1,7,26,0,0,2,4,6,1,0,0,1,5,21
Texas-El Paso1,1,Omega Harris,SR,G,Texas-El Paso,CUSA,31,1013,127,285,81,162,46,123,66,87,5,111,116,63,30,5,48,68,366
Texas-El Paso2,2,Isiah Osborne,SO,G,Texas-El Paso,CUSA,29,780,92,244,51,119,41,125,47,75,15,91,106,30,19,3,25,39,272
Texas-El Paso3,3,Paul Thomas,JR,F,Texas-El Paso,CUSA,31,774,106,229,98,200,8,29,34,67,34,132,166,42,11,10,58,103,254
Texas-El Paso4,4,Evan Gilyard,FR,G,Texas-El Paso,CUSA,31,625,88,231,62,142,26,89,81,96,8,51,59,51,26,1,69,70,283
Texas-El Paso5,5,Kobe Magee,FR,G,Texas-El Paso,CUSA,30,580,50,113,19,40,31,73,4,9,12,48,60,52,9,0,33,22,135
Texas-El Paso6,6,Matt Willms,SR,C,Texas-El Paso,CUSA,23,517,74,126,74,124,0,2,45,72,44,81,125,18,6,27,38,58,193
Texas-El Paso7,7,Keith Frazier,SR,G,Texas-El Paso,CUSA,19,469,74,182,33,62,41,120,23,31,9,81,90,20,9,7,32,27,212
Texas-El Paso8,8,Trey Wade,FR,F,Texas-El Paso,CUSA,25,444,76,159,59,108,17,51,8,24,28,75,103,9,10,23,18,40,177
Texas-El Paso9,9,Jake Flaggert,SR,F,Texas-El Paso,CUSA,29,360,7,30,0,3,7,27,12,14,4,26,30,20,2,2,6,64,33
Texas-El Paso10,10,Tirus Smith,FR,F,Texas-El Paso,CUSA,24,327,37,81,36,77,1,4,28,46,27,48,75,4,2,11,29,69,103
Texas-El Paso11,11,Trey Touchet,JR,G,Texas-El Paso,CUSA,27,296,23,56,17,32,6,24,11,16,4,25,29,19,5,0,18,16,63
Texas-El Paso12,12,Deshaun Highler,,G,Texas-El Paso,CUSA,1,10,0,0,0,0,0,0,3,4,0,0,0,0,0,0,1,0,3
Texas-El Paso13,13,Corbin Stephens,,G,Texas-El Paso,CUSA,1,5,0,0,0,0,0,0,0,0,0,0,0,0,0,0,0,0,0
Texas-Rio Grande Valley1,1,Nick Dixon,SR,G,Texas-Rio Grande Valley,WAC,32,946,193,432,139,281,54,151,219,276,51,89,140,73,46,6,79,61,659
Texas-Rio Grande Valley2,2,Moe McDonald,SR,G,Texas-Rio Grande Valley,WAC,31,678,55,166,34,85,21,81,59,79,15,68,83,67,24,1,53,54,190
Texas-Rio Grande Valley3,3,Javon Levi,FR,G,Texas-Rio Grande Valley,WAC,29,667,38,115,31,88,7,27,37,61,4,64,68,109,34,1,42,62,120
Texas-Rio Grande Valley4,4,Xavier McDaniel Jr.,SO,G,Texas-Rio Grande Valley,WAC,31,619,102,261,76,172,26,89,65,87,39,95,134,28,17,25,44,87,295
Texas-Rio Grande Valley5,5,Greg Bowie,FR,G,Texas-Rio Grande Valley,WAC,28,595,78,204,45,109,33,95,19,27,18,48,66,41,31,0,37,46,208
Texas-Rio Grande Valley6,6,Lesley Varner Jr.,SO,F,Texas-Rio Grande Valley,WAC,32,546,52,138,38,86,14,52,48,68,43,61,104,20,31,10,24,60,166
Texas-Rio Grande Valley7,7,Lew Stallworth,JR,G,Texas-Rio Grande Valley,WAC,27,526,50,127,32,68,18,59,33,46,15,65,80,87,17,1,41,51,151
Texas-Rio Grande Valley8,8,Dan Kimasa,SR,F,Texas-Rio Grande Valley,WAC,32,445,59,130,59,128,0,2,19,27,25,48,73,7,6,14,19,68,137
Texas-Rio Grande Valley9,9,Michael Hoffman,SR,F,Texas-Rio Grande Valley,WAC,30,436,48,128,26,62,22,66,20,25,23,51,74,17,14,12,14,63,138
Texas-Rio Grande Valley10,10,Terry Winn,,F,Texas-Rio Grande Valley,WAC,18,349,62,152,60,145,2,7,42,57,36,87,123,16,6,7,27,41,168
Texas-Rio Grande Valley11,11,John Crnogorac,JR,C,Texas-Rio Grande Valley,WAC,28,284,40,78,40,76,0,2,10,17,16,35,51,6,5,19,19,38,90
Texas-Rio Grande Valley12,12,Adonis Rwabigwi,SR,F,Texas-Rio Grande Valley,WAC,28,260,15,41,15,41,0,0,22,30,15,37,52,4,6,10,15,62,52
Texas-Rio Grande Valley13,13,Jordan Jackson,JR,G,Texas-Rio Grande Valley,WAC,5,71,14,27,13,17,1,10,11,16,5,10,15,3,6,1,5,6,40
Texas-Rio Grande Valley14,14,Marlon Williams,FR,G,Texas-Rio Grande Valley,WAC,10,23,1,5,1,1,0,4,0,2,1,2,3,2,2,0,2,2,2
Texas-Rio Grande Valley15,15,Nick Mora,,G,Texas-Rio Grande Valley,WAC,3,5,0,0,0,0,0,0,0,0,0,1,1,2,0,0,2,1,0
Texas-San Antonio1,1,Keaton Wallace,FR,G,Texas-San Antonio,CUSA,33,909,131,363,62,154,69,209,40,54,22,77,99,89,28,13,57,66,371
Texas-San Antonio2,2,Giovanni De Nicolao,SO,G,Texas-San Antonio,CUSA,33,907,97,244,66,151,31,93,48,67,12,96,108,114,47,3,66,93,273
Texas-San Antonio3,3,Byron Frohnen,SO,F,Texas-San Antonio,CUSA,33,896,100,191,100,180,0,11,47,71,64,179,243,69,31,13,39,59,247
Texas-San Antonio4,4,Nick Allen,JR,F,Texas-San Antonio,CUSA,33,802,111,214,80,143,31,71,34,47,57,110,167,31,16,13,53,90,287
Texas-San Antonio5,5,Jhivvan Jackson,FR,G,Texas-San Antonio,CUSA,29,745,174,404,97,195,77,209,109,142,9,85,94,52,30,2,70,70,534
Texas-San Antonio6,6,Deon Lyle,JR,G,Texas-San Antonio,CUSA,33,629,129,306,38,85,91,221,25,37,29,89,118,12,8,3,32,68,374
Texas-San Antonio7,7,Austin Karrer,SR,G,Texas-San Antonio,CUSA,33,602,27,70,10,23,17,47,12,17,26,83,109,32,21,1,15,63,83
Texas-San Antonio8,8,George Willborn III,SO,G,Texas-San Antonio,CUSA,33,549,88,191,75,153,13,38,67,118,55,86,141,38,18,7,40,72,256
Texas-San Antonio9,9,Kendell Ramlal,SR,F,Texas-San Antonio,CUSA,29,269,31,54,31,54,0,0,16,27,28,48,76,3,8,25,18,40,78
Texas-San Antonio10,10,Toby Van Ry,JR,F,Texas-San Antonio,CUSA,23,197,15,35,11,22,4,13,7,12,12,39,51,13,1,9,18,39,41
Texas-San Antonio11,11,Mitar Stanojevic,SO,F,Texas-San Antonio,CUSA,9,49,7,15,7,10,0,5,6,10,6,6,12,5,0,0,3,1,20
Texas-San Antonio12,12,James Ringholt,SR,C,Texas-San Antonio,CUSA,10,31,4,12,2,4,2,8,6,7,1,8,9,1,0,0,1,4,16
Texas-San Antonio13,13,Kyle Massie,JR,G,Texas-San Antonio,CUSA,9,20,1,4,1,3,0,1,3,4,0,2,2,3,0,0,0,1,5
Texas-San Antonio14,14,Adrian Rodriguez,FR,F,Texas-San Antonio,CUSA,1,14,5,7,5,7,0,0,0,0,4,4,8,1,0,0,0,0,10
Toledo1,1,Jaelan Sanford,JR,G,Toledo,MAC,34,1175,186,412,115,236,71,176,110,130,21,96,117,101,20,19,62,61,553
Toledo2,2,Nate Navigato,JR,F,Toledo,MAC,34,1107,132,293,38,73,94,220,58,74,29,114,143,59,14,18,21,52,416
Toledo3,3,Tre'Shaun Fletcher,,G,Toledo,MAC,33,1087,205,443,156,303,49,140,139,195,59,205,264,142,27,7,79,75,598
Toledo4,4,Marreon Jackson,FR,G,Toledo,MAC,33,979,83,205,21,58,62,147,36,48,17,78,95,89,25,4,51,59,264
Toledo5,5,Luke Knapke,SO,F,Toledo,MAC,34,808,135,243,113,185,22,58,75,100,61,152,213,40,10,60,63,106,367
Toledo6,6,Taylor Adway,JR,F,Toledo,MAC,34,504,57,117,57,116,0,1,45,68,33,91,124,14,11,22,36,87,159
Toledo7,7,Willie Jackson,,F,Toledo,MAC,20,379,57,106,56,102,1,4,37,63,43,68,111,23,8,3,37,37,152
Toledo8,8,Dylan Alderson,FR,G,Toledo,MAC,33,340,19,45,11,23,8,22,5,9,9,40,49,20,9,0,19,21,51
Toledo9,9,Justin Roberts,SO,G,Toledo,MAC,32,284,18,43,3,11,15,32,13,17,1,20,21,28,1,0,8,26,64
Toledo10,10,James Gordon IV,,F,Toledo,MAC,12,62,12,25,10,21,2,4,4,7,6,7,13,4,1,0,6,6,30
Toledo11,11,Dwayne Rose Jr.,FR,G,Toledo,MAC,13,48,5,10,3,6,2,4,11,11,3,8,11,4,1,2,4,8,23
Toledo12,12,Vicpatrick Harris,SR,G,Toledo,MAC,6,15,2,4,2,2,0,2,1,2,0,2,2,3,0,0,0,2,5
Toledo13,13,Matt Schaffer,SO,G,Toledo,MAC,6,12,2,7,1,2,1,5,0,1,0,0,0,1,0,0,0,1,5
Towson1,1,Zane Martin,SO,G,Towson,CAA,32,966,226,493,155,306,71,187,112,161,18,95,113,85,25,6,76,66,635
Towson2,2,Brian Starr,SR,G,Towson,CAA,30,919,75,187,42,105,33,82,64,78,10,69,79,78,33,5,60,53,247
Towson3,3,Mike Morsell,SR,G,Towson,CAA,32,899,162,369,111,222,51,147,73,101,46,88,134,30,33,14,56,94,448
Towson4,4,Eddie Keith,SR,G,Towson,CAA,32,794,111,227,98,180,13,47,45,85,55,102,157,66,28,36,45,105,280
Towson5,5,Justin Gorham,SO,F,Towson,CAA,32,735,119,221,116,207,3,14,73,103,75,140,215,24,11,6,49,79,314
Towson6,6,Jordan McNeil,JR,G,Towson,CAA,31,523,53,121,28,57,25,64,14,23,6,44,50,24,18,3,25,40,145
Towson7,7,Alex Thomas,JR,F,Towson,CAA,32,512,34,75,34,74,0,1,18,34,49,76,125,12,9,26,20,81,86
Towson8,8,Dennis Tunstall,SO,F,Towson,CAA,32,481,41,56,41,56,0,0,5,11,50,80,130,8,18,35,15,59,87
Towson9,9,Deshaun Morman,SR,G,Towson,CAA,23,477,58,117,46,89,12,28,52,65,14,51,65,35,29,8,40,42,180
Towson10,10,Travis Ingram,FR,G,Towson,CAA,13,105,8,20,6,14,2,6,1,2,11,11,22,9,2,0,4,7,19
Towson11,11,Jeffrey Prophete,FR,G,Towson,CAA,13,65,1,8,1,6,0,2,1,2,0,4,4,7,2,0,8,6,3
Towson12,12,Van Rolle,SR,G,Towson,CAA,7,24,1,11,1,7,0,4,0,2,0,1,1,3,1,0,1,1,2
Troy1,1,Wesley Person,SR,G,Troy,Sun Belt,33,1123,174,416,77,160,97,256,137,167,21,75,96,59,24,1,61,63,582
Troy2,2,B.J. Miller,JR,G,Troy,Sun Belt,33,935,92,185,77,137,15,48,50,64,24,76,100,104,41,11,56,81,249
Troy3,3,Alex Hicks,JR,F,Troy,Sun Belt,33,872,148,265,131,218,17,47,74,100,75,202,277,36,24,37,56,90,387
Troy4,4,Kevin Baker,SR,G,Troy,Sun Belt,33,817,61,225,16,59,45,166,57,81,9,77,86,104,25,0,63,67,224
Troy5,5,Jordon Varnado,JR,F,Troy,Sun Belt,26,810,174,364,148,274,26,90,93,126,49,134,183,44,18,36,56,71,467
Troy6,6,Juan Davis Jr.,SR,F,Troy,Sun Belt,31,660,61,147,28,57,33,90,23,33,43,99,142,5,6,9,19,71,178
Troy7,7,Javan Johnson,FR,F,Troy,Sun Belt,33,557,67,145,32,65,35,80,21,34,32,67,99,19,7,21,39,53,190
Troy8,8,Darian Adams,FR,G,Troy,Sun Belt,32,496,31,90,21,47,10,43,21,36,12,47,59,35,11,3,27,39,93
Troy9,9,Shawn Hopkins,JR,G,Troy,Sun Belt,26,277,30,69,18,31,12,38,10,14,11,29,40,16,6,5,15,25,82
Troy10,10,Malik Burnett,FR,G,Troy,Sun Belt,16,91,8,21,6,13,2,8,1,7,0,12,12,12,3,1,10,9,19
Troy11,11,Whit Moreman,SO,F,Troy,Sun Belt,6,11,2,3,2,3,0,0,0,0,1,2,3,1,0,0,0,1,4
Troy12,12,Jaro Moravek,SR,F,Troy,Sun Belt,1,1,0,0,0,0,0,0,0,0,0,0,0,0,0,0,0,0,0
Tulane1,1,Cameron Reynolds,SR,G,Tulane,AAC,31,1117,171,419,110,246,61,173,64,91,36,160,196,68,24,18,47,77,467
Tulane2,2,Melvin Frazier,JR,G,Tulane,AAC,30,1032,179,322,144,231,35,91,84,118,35,133,168,86,63,22,77,60,477
Tulane3,3,Ray Ona Embo,SO,G,Tulane,AAC,29,960,101,234,55,108,46,126,46,64,14,79,93,95,23,5,47,73,294
Tulane4,4,Jordan Cornish,JR,G,Tulane,AAC,31,937,103,275,62,150,41,125,60,86,12,88,100,101,11,10,74,46,307
Tulane5,5,Samir Sehic,SO,F,Tulane,AAC,31,631,111,194,93,142,18,52,84,118,74,88,162,24,11,14,35,67,324
Tulane6,6,Caleb Daniels,FR,G,Tulane,AAC,30,550,60,140,39,87,21,53,52,65,20,46,66,44,7,10,35,82,193
Tulane7,7,Blake Paul,JR,F,Tulane,AAC,31,469,42,80,42,80,0,0,19,31,32,63,95,25,5,39,40,76,103
Tulane8,8,Colin Slater,SO,G,Tulane,AAC,30,311,26,76,16,35,10,41,18,22,3,20,23,29,9,2,20,28,80
Tulane9,9,Bul Ajang,FR,F,Tulane,AAC,21,163,6,25,6,24,0,1,5,8,15,16,31,6,1,3,13,35,17
Tulane10,10,Shakwon Barrett,FR,G,Tulane,AAC,7,31,0,7,0,7,0,0,3,7,0,1,1,5,0,0,1,1,3
Tulane11,11,Buay Koka,FR,C,Tulane,AAC,7,27,1,4,1,4,0,0,1,1,3,9,12,0,1,3,4,6,3
Tulane12,12,Riley Conroy,JR,G,Tulane,AAC,5,8,0,1,0,0,0,1,0,0,0,1,1,0,0,0,0,2,0
Tulane13,13,Sammis Reyes,JR,F,Tulane,AAC,2,7,0,1,0,1,0,0,0,0,1,1,2,0,0,0,2,4,0
Tulane14,14,Jackson Johnson,JR,G,Tulane,AAC,3,4,0,0,0,0,0,0,1,2,0,2,2,0,0,0,0,0,1
Tulane15,15,Cameron Galic,,F,Tulane,AAC,2,3,0,1,0,1,0,0,0,0,0,1,1,0,0,0,0,0,0
Tulsa1,1,Junior Etou,SR,F,Tulsa,AAC,31,942,145,310,103,191,42,119,133,186,77,167,244,47,16,8,74,66,465
Tulsa2,2,Corey Henderson,SR,G,Tulsa,AAC,31,874,99,268,26,72,73,196,55,70,10,58,68,38,19,0,21,40,326
Tulsa3,3,Sterling Taplin,JR,G,Tulsa,AAC,30,845,127,275,89,170,38,105,62,85,5,107,112,132,28,4,72,55,354
Tulsa4,4,Martins Igbanu,SO,F,Tulsa,AAC,31,697,99,187,97,180,2,7,90,125,57,101,158,15,9,5,46,54,290
Tulsa5,5,Jaleel Wheeler,SR,G,Tulsa,AAC,31,568,49,116,47,101,2,15,38,61,34,78,112,23,13,6,35,53,138
Tulsa6,6,DaQuan Jeffries,,F,Tulsa,AAC,25,549,90,166,66,105,24,61,38,48,45,78,123,20,15,36,35,79,242
Tulsa7,7,Elijah Joiner,FR,G,Tulsa,AAC,31,522,32,109,8,41,24,68,30,49,9,55,64,63,9,0,43,53,118
Tulsa8,8,Curran Scott,SO,G,Tulsa,AAC,31,461,53,133,35,82,18,51,58,69,17,49,66,21,10,1,35,37,182
Tulsa9,9,Lawson Korita,SO,G,Tulsa,AAC,29,389,29,71,14,27,15,44,7,9,10,33,43,18,7,0,13,20,80
Tulsa10,10,Geno Artison,JR,F,Tulsa,AAC,30,334,23,73,14,34,9,39,11,15,17,50,67,11,9,8,7,20,66
Tulsa11,11,Darien Jackson,FR,G,Tulsa,AAC,18,91,7,21,7,16,0,5,0,3,4,4,8,3,5,0,7,18,14
Tulsa12,12,Alex Foree,,F,Tulsa,AAC,3,3,1,2,1,1,0,1,0,0,0,1,1,0,0,0,0,0,2
UC-Davis1,1,TJ Shorts II,JR,G,UC-Davis,Big West,32,1024,160,306,150,278,10,28,152,204,12,106,118,139,64,7,79,65,482
UC-Davis2,2,Siler Schneider,JR,G,UC-Davis,Big West,32,963,171,383,135,273,36,110,70,97,15,85,100,70,35,8,80,82,448
UC-Davis3,3,Garrison Goode,JR,F,UC-Davis,Big West,31,872,55,114,55,114,0,0,35,64,46,70,116,23,22,13,40,85,145
UC-Davis4,4,Michael Onyebalu,SR,G,UC-Davis,Big West,31,843,51,118,21,49,30,69,45,56,9,110,119,31,23,2,48,81,177
UC-Davis5,5,A.J. John,JR,F,UC-Davis,Big West,32,672,90,188,48,77,42,111,28,36,39,89,128,14,9,15,26,86,250
UC-Davis6,6,Chima Moneke,SR,F,UC-Davis,Big West,21,631,134,260,125,236,9,24,110,154,45,155,200,21,21,23,56,59,387
UC-Davis7,7,Joe Mooney,SO,G,UC-Davis,Big West,27,500,63,147,25,50,38,97,14,22,8,33,41,23,24,1,24,40,178
UC-Davis8,8,Rogers Printup,SO,G,UC-Davis,Big West,24,337,33,85,10,18,23,67,6,6,2,30,32,8,8,4,12,37,95
UC-Davis9,9,Arell Hennings,SR,G,UC-Davis,Big West,32,327,30,70,14,36,16,34,25,27,6,16,22,44,12,0,23,26,101
UC-Davis10,10,Colin Russell,JR,F,UC-Davis,Big West,25,224,16,34,16,34,0,0,10,21,22,20,42,6,2,1,10,47,42
UC-Davis11,11,Delveion Jackson,FR,G,UC-Davis,Big West,18,205,9,32,5,17,4,15,2,7,12,20,32,14,7,1,8,13,24
UC-Davis12,12,Logan Strom,FR,F,UC-Davis,Big West,1,2,0,0,0,0,0,0,0,0,0,0,0,0,0,0,0,0,0
UC-Irvine1,1,Eyassu Worku,SO,G,UC-Irvine,Big West,35,999,147,386,114,280,33,106,68,90,23,84,107,130,40,1,77,55,395
UC-Irvine2,2,Evan Leonard,SO,G,UC-Irvine,Big West,35,977,161,360,94,191,67,169,88,111,16,98,114,69,48,4,60,97,477
UC-Irvine3,3,Jonathan Galloway,JR,F,UC-Irvine,Big West,35,893,51,108,51,108,0,0,25,43,78,186,264,18,17,47,45,105,127
UC-Irvine4,4,John Edgar Jr.,SO,F,UC-Irvine,Big West,35,850,117,285,82,157,35,128,24,33,32,110,142,34,14,1,52,49,293
UC-Irvine5,5,Max Hazzard,SO,G,UC-Irvine,Big West,33,750,93,257,41,114,52,143,38,49,10,56,66,64,17,0,55,49,276
UC-Irvine6,6,Tommy Rutherford,SO,F,UC-Irvine,Big West,35,747,133,228,127,214,6,14,82,115,62,137,199,28,9,23,72,103,354
UC-Irvine7,7,Elston Jones,JR,F,UC-Irvine,Big West,34,534,69,122,69,122,0,0,15,43,74,115,189,18,8,30,39,95,153
UC-Irvine8,8,Brad Greene,SO,C,UC-Irvine,Big West,35,427,63,132,63,132,0,0,36,48,53,85,138,11,4,27,26,75,162
UC-Irvine9,9,Brandon Smith,JR,F,UC-Irvine,Big West,30,373,26,68,25,44,1,24,14,20,7,39,46,26,9,6,24,41,67
UC-Irvine10,10,Darrian Traylor,SO,G,UC-Irvine,Big West,28,204,19,52,6,14,13,38,13,21,8,28,36,8,5,0,13,15,64
UC-Irvine11,11,Riley Welch,FR,G,UC-Irvine,Big West,27,141,4,13,2,5,2,8,4,5,2,12,14,15,2,0,7,22,14
UC-Irvine12,12,Justin Wertner,FR,G,UC-Irvine,Big West,20,139,14,38,4,14,10,24,9,9,10,9,19,6,4,1,3,12,47
UC-Irvine13,13,Teo Davidian,,G,UC-Irvine,Big West,10,16,3,12,2,9,1,3,4,6,3,2,5,3,1,0,1,1,11
UCLA1,1,Aaron Holiday,JR,G,UCLA,Pac-12,32,1204,205,443,121,249,84,194,157,190,16,100,116,185,42,8,115,82,651
UCLA2,2,Thomas Welsh,SR,C,UCLA,Pac-12,32,1064,161,329,116,219,45,110,48,58,85,258,343,46,22,29,31,78,415
UCLA3,3,Kris Wilkes,FR,G,UCLA,Pac-12,32,949,157,356,104,203,53,153,75,114,43,116,159,53,24,18,41,81,442
UCLA4,4,Gyorgy Goloman,SR,F,UCLA,Pac-12,32,783,84,154,66,112,18,42,47,75,53,85,138,39,19,38,34,110,233
UCLA5,5,Jaylen Hands,FR,G,UCLA,Pac-12,30,758,101,248,59,136,42,112,58,78,18,100,118,80,30,4,55,49,302
UCLA6,6,Prince Ali,SO,G,UCLA,Pac-12,32,733,98,224,64,130,34,94,58,90,23,77,100,45,25,5,44,56,288
UCLA7,7,Alex Olesinski,SO,F,UCLA,Pac-12,32,576,47,91,31,47,16,44,31,43,41,83,124,15,11,15,15,73,141
UCLA8,8,Chris Smith,FR,G,UCLA,Pac-12,32,421,47,106,42,79,5,27,31,53,16,45,61,17,8,7,38,38,130
UCLA9,9,Ikenna Okwarabizie,SR,C,UCLA,Pac-12,7,29,3,5,3,4,0,1,0,0,2,7,9,0,1,1,1,4,6
UCLA10,10,Alec Wulff,SR,G,UCLA,Pac-12,9,24,3,5,0,1,3,4,2,2,0,0,0,2,1,0,1,1,11
UCLA11,11,Joseph Wallace,FR,G,UCLA,Pac-12,2,3,0,0,0,0,0,0,0,0,1,0,1,0,0,0,0,0,0
UCLA12,12,Isaac Wulff,SO,G,UCLA,Pac-12,2,3,0,3,0,1,0,2,2,2,0,0,0,0,0,0,0,1,2
UCLA13,13,Armani Dodson,SO,G,UCLA,Pac-12,2,3,0,0,0,0,0,0,0,0,1,1,2,0,0,0,0,1,0
UC-Riverside1,1,Chance Murray,JR,G,UC-Riverside,Big West,31,1056,131,381,92,241,39,140,92,134,24,142,166,119,55,7,79,58,393
UC-Riverside2,2,Dikymbe Martin,FR,G,UC-Riverside,Big West,25,786,116,275,85,199,31,76,76,89,14,75,89,71,30,0,68,56,339
UC-Riverside3,3,Alex Larsson,SO,F,UC-Riverside,Big West,28,667,111,210,111,210,0,0,52,82,55,105,160,20,8,17,67,82,274
UC-Riverside4,4,Brandon Rosser,JR,F,UC-Riverside,Big West,31,651,66,145,52,100,14,45,37,53,30,82,112,28,9,20,35,93,183
UC-Riverside5,5,DJ Sylvester,FR,G,UC-Riverside,Big West,27,650,64,184,37,104,27,80,54,80,15,62,77,26,15,1,36,56,209
UC-Riverside6,6,Menno Dijkstra,FR,C,UC-Riverside,Big West,30,439,66,141,44,87,22,54,16,18,28,53,81,16,8,13,16,45,170
UC-Riverside7,7,James Jackson,JR,F,UC-Riverside,Big West,30,367,26,65,19,41,7,24,7,22,16,51,67,24,3,4,23,33,66
UC-Riverside8,8,Koh Flippin,FR,G,UC-Riverside,Big West,25,342,26,82,11,29,15,53,17,25,13,28,41,28,32,5,14,35,84
UC-Riverside9,9,Idy Diallo,SO,C,UC-Riverside,Big West,27,300,30,57,30,57,0,0,9,16,29,60,89,7,6,17,32,73,69
UC-Riverside10,10,Ajani Kennedy,,F,UC-Riverside,Big West,22,221,26,53,20,37,6,16,20,24,12,22,34,12,4,7,18,26,78
UC-Riverside11,11,Alec Hickman,FR,G,UC-Riverside,Big West,18,206,15,47,8,15,7,32,0,1,5,15,20,8,6,1,2,9,37
UC-Riverside12,12,Dominick Pickett,FR,G,UC-Riverside,Big West,20,203,10,33,7,19,3,14,2,3,4,15,19,17,6,1,13,17,25
UC-Riverside13,13,Eric Rwahwire,FR,F,UC-Riverside,Big West,15,154,16,56,7,23,9,33,6,7,6,18,24,4,3,2,6,16,47
UC-Riverside14,14,Ryker Pierce,,G,UC-Riverside,Big West,13,92,4,24,1,6,3,18,8,10,3,3,6,2,4,0,2,13,19
UC-Riverside15,15,Jayvon Brown,JR,G,UC-Riverside,Big West,9,89,9,26,7,15,2,11,11,15,1,6,7,5,1,0,10,5,31
UC-Riverside16,16,Marcus Berkley,,G,UC-Riverside,Big West,1,2,0,1,0,0,0,1,0,0,0,0,0,0,0,0,1,0,0
UC-Santa Barbara1,1,Max Heidegger,SO,G,UC-Santa Barbara,Big West,32,1053,195,451,100,216,95,235,127,166,11,68,79,79,19,2,50,69,612
UC-Santa Barbara2,2,Leland King,SR,F,UC-Santa Barbara,Big West,32,1017,186,401,133,273,53,128,73,97,66,261,327,61,24,5,40,52,498
UC-Santa Barbara3,3,Marcus Jackson,SR,G,UC-Santa Barbara,Big West,28,933,82,205,39,85,43,120,27,45,3,63,66,113,21,7,52,34,234
UC-Santa Barbara4,4,Gabe Vincent,SR,G,UC-Santa Barbara,Big West,32,932,138,307,83,161,55,146,66,82,3,58,61,104,35,6,38,92,397
UC-Santa Barbara5,5,Jalen Canty,SR,F,UC-Santa Barbara,Big West,26,714,129,220,129,220,0,0,72,109,89,111,200,25,14,48,33,64,330
UC-Santa Barbara6,6,Christian Terrell,SO,G,UC-Santa Barbara,Big West,30,533,34,75,29,55,5,20,12,19,23,71,94,53,19,6,30,54,85
UC-Santa Barbara7,7,Ami Lakoju,JR,F,UC-Santa Barbara,Big West,32,384,58,99,58,99,0,0,11,24,51,55,106,2,2,19,30,67,127
UC-Santa Barbara8,8,Jarriesse Blackmon,JR,F,UC-Santa Barbara,Big West,23,268,17,36,16,33,1,3,9,15,22,38,60,6,4,14,11,40,44
UC-Santa Barbara9,9,Brandon Davis,FR,G,UC-Santa Barbara,Big West,28,189,7,19,5,13,2,6,4,9,1,16,17,22,7,0,15,22,20
UC-Santa Barbara10,10,Alex Hart,SR,F,UC-Santa Barbara,Big West,24,150,14,31,14,31,0,0,9,16,13,25,38,1,3,5,7,16,37
UC-Santa Barbara11,11,Maxwell Kupchak,JR,F,UC-Santa Barbara,Big West,21,114,6,12,6,12,0,0,3,7,4,22,26,5,3,5,5,15,15
UC-Santa Barbara12,12,Sam Walters,JR,G,UC-Santa Barbara,Big West,9,61,4,12,2,2,2,10,0,0,1,7,8,8,2,0,6,5,10
UC-Santa Barbara13,13,Clifton Powell,SO,G,UC-Santa Barbara,Big West,7,39,3,11,3,8,0,3,0,2,0,3,3,2,0,1,5,4,6
UC-Santa Barbara14,14,J.D. Slajchert,JR,F,UC-Santa Barbara,Big West,7,28,3,9,2,6,1,3,1,2,2,4,6,0,1,0,3,2,8
UC-Santa Barbara15,15,Andrew Pickles,SO,F,UC-Santa Barbara,Big West,2,10,1,3,1,3,0,0,0,1,2,1,3,0,0,0,0,0,2
University of California1,1,Darius McNeill,FR,G,University of California,Pac-12,32,1051,128,336,61,146,67,190,40,54,10,84,94,70,39,6,70,76,363
University of California2,2,Justice Sueing,FR,F,University of California,Pac-12,32,1023,157,362,115,227,42,135,86,128,48,123,171,44,48,15,68,75,442
University of California3,3,Don Coleman,JR,G,University of California,Pac-12,30,943,127,387,101,280,26,107,147,197,32,56,88,57,42,1,60,68,427
University of California4,4,Marcus Lee,SR,F,University of California,Pac-12,32,888,151,268,151,268,0,0,63,103,98,132,230,42,21,52,85,115,365
University of California5,5,Kingsley Okoroh,SR,C,University of California,Pac-12,32,804,68,168,68,168,0,0,45,66,65,108,173,26,8,66,40,95,181
University of California6,6,Juhwan Harris-Dyson,FR,G,University of California,Pac-12,30,582,70,142,70,129,0,13,47,82,46,56,102,31,34,7,54,73,187
University of California7,7,Nick Hamilton,SR,G,University of California,Pac-12,31,443,19,55,15,41,4,14,17,25,23,35,58,22,15,1,31,55,59
University of California8,8,Roman Davis,SO,F,University of California,Pac-12,25,205,17,53,15,45,2,8,12,26,16,37,53,9,4,1,13,31,48
University of California9,9,Grant Anticevich,FR,F,University of California,Pac-12,23,171,11,35,9,22,2,13,10,13,11,25,36,3,2,3,10,18,34
University of California10,10,Deschon Winston,FR,G,University of California,Pac-12,25,163,15,50,11,27,4,23,7,9,5,11,16,7,4,0,18,17,41
University of California11,11,Austin McCullough,FR,G,University of California,Pac-12,19,91,0,12,0,2,0,10,2,2,0,4,4,2,1,0,4,10,2
University of California12,12,Cole Welle,,F,University of California,Pac-12,15,51,2,15,2,12,0,3,6,10,10,5,15,0,2,2,1,14,10
University of California13,13,Jacob Orender,JR,G,University of California,Pac-12,3,5,0,1,0,1,0,0,2,2,0,1,1,0,0,0,0,1,2
University of California14,14,Derek King,FR,G,University of California,Pac-12,3,4,2,3,1,1,1,2,0,0,0,2,2,0,0,0,1,0,5
University of California15,15,Jules Erving,FR,F,University of California,Pac-12,1,1,0,0,0,0,0,0,0,0,0,1,1,0,0,0,0,0,0
Utah1,1,Justin Bibbins,SR,G,Utah,Pac-12,30,1034,132,284,51,103,81,181,90,105,11,77,88,145,39,4,57,77,435
Utah2,2,Tyler Rawson,SR,F,Utah,Pac-12,30,928,103,236,51,95,52,141,59,76,34,170,204,115,21,30,59,61,317
Utah3,3,Sedrick Barefield,JR,G,Utah,Pac-12,27,760,94,251,52,118,42,133,76,86,6,50,56,68,24,3,51,40,306
Utah4,4,David Collette,SR,F,Utah,Pac-12,29,633,152,238,150,232,2,6,68,95,43,93,136,32,25,20,40,82,374
Utah5,5,Parker Van Dyke,FR,G,Utah,Pac-12,30,582,46,120,16,28,30,92,16,24,4,31,35,47,15,1,22,23,138
Utah6,6,Gabe Bealer,SR,G,Utah,Pac-12,28,524,58,132,16,28,42,104,7,10,6,50,56,10,8,2,16,36,165
Utah7,7,Donnie Tillman,FR,F,Utah,Pac-12,23,462,64,136,55,110,9,26,48,57,31,73,104,12,9,6,33,42,185
Utah8,8,Jayce Johnson,SO,F,Utah,Pac-12,26,437,47,95,47,95,0,0,44,71,44,97,141,5,9,26,28,62,138
Utah9,9,Kolbe Caldwell,SO,G,Utah,Pac-12,23,292,21,61,10,24,11,37,5,7,5,19,24,15,5,1,21,27,58
Utah10,10,Chris Seeley,FR,F,Utah,Pac-12,17,136,19,43,19,40,0,3,13,28,12,34,46,8,1,8,11,25,51
Utah11,11,Christian Popoola,FR,G,Utah,Pac-12,15,93,4,16,4,11,0,5,5,6,0,13,13,2,2,0,8,13,13
Utah12,12,Jake Connor,JR,G,Utah,Pac-12,14,77,5,22,0,2,5,20,2,5,2,4,6,2,0,2,0,6,17
Utah13,13,Jakub Jokl,SO,F,Utah,Pac-12,10,37,3,4,3,4,0,0,2,2,6,4,10,1,0,2,3,6,8
Utah14,14,Beau Rydalch,,G,Utah,Pac-12,4,13,0,0,0,0,0,0,0,0,1,1,2,1,0,1,1,1,0
Utah15,15,Marc Reininger,SO,F,Utah,Pac-12,5,13,0,1,0,1,0,0,0,0,0,2,2,0,0,0,0,2,0
Utah16,16,Nate Duda,SO,G,Utah,Pac-12,1,4,0,0,0,0,0,0,0,0,0,0,0,0,0,0,0,0,0
Utah State1,1,Sam Merrill,SO,G,Utah State,MWC,34,1202,192,381,94,170,98,211,73,86,7,105,112,107,35,7,62,75,555
Utah State2,2,Koby McEwen,,G,Utah State,MWC,30,970,150,375,83,172,67,203,100,138,13,150,163,97,23,1,89,78,467
Utah State3,3,Dwayne Brown Jr.,JR,F,Utah State,MWC,34,871,115,257,84,158,31,99,45,64,49,120,169,47,21,8,57,90,306
Utah State4,4,Diogo Brito,SO,G,Utah State,MWC,34,836,76,165,55,95,21,70,32,53,21,97,118,67,27,2,53,53,205
Utah State5,5,Quinn Taylor,JR,F,Utah State,MWC,33,763,92,152,78,118,14,34,26,46,67,87,154,45,13,24,28,83,224
Utah State6,6,Alexis Dargenton,SR,F,Utah State,MWC,29,522,59,108,58,104,1,4,65,97,36,58,94,28,12,15,43,61,184
Utah State7,7,DeAngelo Isby,JR,G,Utah State,MWC,28,521,79,187,57,109,22,78,55,69,23,57,80,32,13,2,43,44,235
Utah State8,8,Daron Henson,FR,F,Utah State,MWC,33,413,46,133,8,34,38,99,12,22,20,44,64,7,1,2,13,50,142
Utah State9,9,Julion Pearre,,G,Utah State,MWC,17,276,25,65,11,30,14,35,17,20,2,23,25,18,11,2,18,21,81
Utah State10,10,Abel Porter,FR,G,Utah State,MWC,22,171,8,21,6,12,2,9,8,15,1,14,15,15,6,1,9,22,26
Utah State11,11,Crew Ainge,FR,G,Utah State,MWC,16,111,2,18,2,9,0,9,4,7,3,5,8,7,6,0,8,15,8
Utah State12,12,Klay Stall,FR,C,Utah State,MWC,10,86,9,16,9,16,0,0,4,9,8,21,29,2,1,4,7,13,22
Utah State13,13,Brock Miller,FR,G,Utah State,MWC,5,83,12,26,3,7,9,19,1,1,2,5,7,1,1,0,6,12,34
Utah Valley1,1,Brandon Randolph,SR,G,Utah Valley,WAC,31,1002,118,274,86,189,32,85,66,89,19,93,112,143,34,3,79,62,334
Utah Valley2,2,Conner Toolson,JR,G,Utah Valley,WAC,32,999,139,297,64,114,75,183,49,61,18,99,117,49,50,11,42,62,402
Utah Valley3,3,Kenneth Ogbe,SR,G,Utah Valley,WAC,31,935,134,289,75,144,59,145,81,117,19,82,101,46,25,7,55,54,408
Utah Valley4,4,Jake Toolson,SO,G,Utah Valley,WAC,31,869,124,245,95,164,29,81,77,91,24,124,148,94,25,7,53,32,354
Utah Valley5,5,Akolda Manyang,SR,C,Utah Valley,WAC,29,623,139,222,139,222,0,0,98,144,79,150,229,24,10,68,69,82,376
Utah Valley6,6,Ben Nakwaasah,JR,G,Utah Valley,WAC,32,539,50,140,23,61,27,79,23,28,9,56,65,67,20,2,39,65,150
Utah Valley7,7,Isaac Neilson,SR,F,Utah Valley,WAC,32,486,67,106,63,97,4,9,27,33,59,89,148,21,16,22,31,64,165
Utah Valley8,8,Zach Nelson,SR,F,Utah Valley,WAC,25,296,36,57,31,52,5,5,28,39,25,51,76,30,4,2,22,28,105
Utah Valley9,9,Jerrelle DeBerry,,G,Utah Valley,WAC,17,285,38,102,22,61,16,41,38,53,15,33,48,12,2,2,22,41,130
Utah Valley10,10,Cory Calvert,JR,G,Utah Valley,WAC,16,141,8,30,6,13,2,17,4,5,3,18,21,19,2,0,11,12,22
Utah Valley11,11,Joonas Tahvanainen,SO,F,Utah Valley,WAC,14,95,5,14,5,9,0,5,3,5,8,14,22,4,2,2,6,16,13
Utah Valley12,12,Mckay Johnson,SO,G,Utah Valley,WAC,14,57,3,6,2,4,1,2,3,7,3,8,11,6,0,0,6,4,10
Utah Valley13,13,Richard Harward,FR,C,Utah Valley,WAC,13,50,5,15,5,15,0,0,6,12,11,13,24,1,0,5,0,7,16
Utah Valley14,14,Daniel Nyman,SO,G,Utah Valley,WAC,12,48,3,9,1,3,2,6,4,4,0,4,4,1,2,0,2,1,12
Valparaiso1,1,Bakari Evelyn,SO,G,Valparaiso,MVC,32,1003,140,312,83,163,57,149,65,85,8,90,98,93,44,3,88,70,402
Valparaiso2,2,Tevonn Walker,SR,G,Valparaiso,MVC,28,864,134,347,95,209,39,138,106,136,32,103,135,48,48,2,48,67,413
Valparaiso3,3,Max Joseph,SR,G,Valparaiso,MVC,32,842,84,173,67,126,17,47,48,80,31,104,135,66,48,2,47,73,233
Valparaiso4,4,Markus Golder,SO,G,Valparaiso,MVC,32,728,109,221,76,144,33,77,54,65,27,111,138,42,26,16,50,74,305
Valparaiso5,5,Derrik Smits,SO,C,Valparaiso,MVC,32,570,91,160,91,160,0,0,57,87,43,71,114,23,6,21,62,76,239
Valparaiso6,6,Micah Bradford,SO,G,Valparaiso,MVC,31,506,55,161,30,70,25,91,24,49,4,41,45,68,21,2,38,60,159
Valparaiso7,7,Jaume Sorolla,SO,C,Valparaiso,MVC,30,488,55,101,55,100,0,1,37,48,44,59,103,7,11,32,25,74,147
Valparaiso8,8,John Kiser,SO,G,Valparaiso,MVC,26,472,19,48,10,22,9,26,25,33,27,69,96,23,12,6,12,45,72
Valparaiso9,9,Mileek McMillan,FR,F,Valparaiso,MVC,32,338,36,87,20,43,16,44,14,18,8,38,46,11,5,7,36,64,102
Valparaiso10,10,Joe Burton,JR,G,Valparaiso,MVC,10,251,39,81,22,36,17,45,20,26,8,26,34,8,1,6,16,14,115
Valparaiso11,11,Parker Hazen,FR,F,Valparaiso,MVC,21,175,6,20,6,14,0,6,8,14,8,17,25,4,1,1,19,22,20
Valparaiso12,12,Marten Linssen,FR,F,Valparaiso,MVC,22,163,13,30,13,30,0,0,19,33,15,29,44,6,12,7,15,39,45
Vanderbilt1,1,Jeff Roberson,SR,F,Vanderbilt,SEC,32,1102,164,343,102,190,62,153,152,178,61,167,228,49,28,11,49,91,542
Vanderbilt2,2,Riley LaChance,SR,G,Vanderbilt,SEC,32,1015,156,341,75,147,81,194,57,73,12,90,102,103,15,0,40,64,450
Vanderbilt3,3,Saben Lee,FR,G,Vanderbilt,SEC,32,857,115,249,92,174,23,75,85,117,22,73,95,99,39,5,71,78,338
Vanderbilt4,4,Joe Toye,JR,G,Vanderbilt,SEC,32,602,68,170,48,94,20,76,27,44,17,48,65,26,9,9,42,66,183
Vanderbilt5,5,Payton Willis,SO,G,Vanderbilt,SEC,31,573,48,138,10,29,38,109,23,35,10,48,58,43,14,3,29,41,157
Vanderbilt6,6,Clevon Brown,SO,F,Vanderbilt,SEC,32,543,51,112,40,66,11,46,12,26,42,56,98,7,9,42,27,67,125
Vanderbilt7,7,Matthew Fisher-Davis,SR,G,Vanderbilt,SEC,17,443,61,162,26,57,35,105,34,39,18,63,81,21,19,9,19,40,191
Vanderbilt8,8,Djery Baptiste,SO,C,Vanderbilt,SEC,29,442,30,66,30,66,0,0,30,41,34,69,103,5,7,26,24,74,90
Vanderbilt9,9,Maxwell Evans,FR,G,Vanderbilt,SEC,29,378,34,95,16,41,18,54,28,33,15,41,56,14,9,0,25,33,114
Vanderbilt10,10,Larry Austin,JR,G,Vanderbilt,SEC,23,254,22,53,21,49,1,4,13,23,10,23,33,24,4,1,15,27,58
Vanderbilt11,11,Ejike Obinna,FR,F,Vanderbilt,SEC,25,235,26,44,26,43,0,1,15,31,12,41,53,1,1,2,13,50,67
Vanderbilt12,12,Isaiah Rice,,G,Vanderbilt,SEC,2,6,0,2,0,0,0,2,1,2,0,0,0,0,0,0,2,1,1
Vermont1,1,Trae Bell-Haynes,SR,G,Vermont,AEC,33,1055,164,320,142,257,22,63,143,196,20,122,142,131,38,4,102,78,493
Vermont2,2,Payton Henson,SR,F,Vermont,AEC,33,1033,142,313,106,225,36,88,90,112,50,136,186,52,11,11,57,51,410
Vermont3,3,Everett Duncan,SO,G,Vermont,AEC,34,960,68,136,19,33,49,103,31,36,30,115,145,15,8,4,15,65,216
Vermont4,4,Ernie Duncan,JR,G,Vermont,AEC,32,946,116,257,50,91,66,166,60,71,6,73,79,73,16,3,39,54,358
Vermont5,5,Drew Urquhart,SR,F,Vermont,AEC,34,813,135,224,122,198,13,26,85,111,45,135,180,56,8,37,36,85,368
Vermont6,6,Cam Ward,SR,G,Vermont,AEC,34,510,52,114,24,47,28,67,29,46,6,39,45,44,11,0,28,40,161
Vermont7,7,Anthony Lamb,SO,F,Vermont,AEC,17,400,80,174,66,132,14,42,66,80,25,62,87,15,9,14,30,39,240
Vermont8,8,Stef Smith,FR,G,Vermont,AEC,33,362,42,110,18,46,24,64,19,30,5,52,57,33,13,0,27,32,127
Vermont9,9,Nate Rohrer,SR,F,Vermont,AEC,27,267,16,31,16,26,0,5,15,22,13,23,36,12,7,6,8,19,47
Vermont10,10,Ben Shungu,FR,G,Vermont,AEC,21,132,9,12,8,10,1,2,6,11,3,17,20,11,3,0,9,15,25
Vermont11,11,Samuel Dingba,JR,F,Vermont,AEC,16,128,13,19,13,19,0,0,10,18,11,17,28,1,4,6,5,20,36
Vermont12,12,RA Kpedi,,F,Vermont,AEC,11,86,9,20,9,20,0,0,7,10,8,14,22,1,1,3,7,10,25
Vermont13,13,Skyler Nash,FR,G,Vermont,AEC,9,69,5,15,0,3,5,12,0,0,0,5,5,3,0,0,4,3,15
Vermont14,14,Bailey Patella,,F,Vermont,AEC,12,30,1,1,1,1,0,0,0,2,0,7,7,3,1,1,0,2,2
Vermont15,15,David Urso,SR,G,Vermont,AEC,5,9,0,1,0,1,0,0,0,0,0,1,1,2,0,0,0,1,0
Villanova1,1,Mikal Bridges,JR,G,Villanova,Big East,34,1109,214,411,126,208,88,203,97,114,49,135,184,72,55,38,47,73,613
Villanova2,2,Jalen Brunson,JR,G,Villanova,Big East,34,1084,237,446,163,267,74,179,111,139,10,95,105,160,29,1,58,63,659
Villanova3,3,Donte DiVincenzo,SO,G,Villanova,Big East,34,1006,159,338,91,160,68,178,61,86,37,120,157,117,40,5,64,72,447
Villanova4,4,Omari Spellman,FR,F,Villanova,Big East,34,959,134,279,81,159,53,120,44,65,77,191,268,27,22,50,31,74,365
Villanova5,5,Eric Paschall,JR,F,Villanova,Big East,32,954,120,226,94,147,26,79,62,75,54,109,163,74,31,20,54,73,328
Villanova6,6,Phil Booth,JR,G,Villanova,Big East,27,732,96,211,46,84,50,127,52,67,9,71,80,76,25,6,38,45,294
Villanova7,7,Dhamir Cosby-Roundtree,FR,F,Villanova,Big East,34,393,47,61,47,61,0,0,10,17,28,54,82,2,9,10,18,60,104
Villanova8,8,Collin Gillespie,FR,G,Villanova,Big East,26,391,38,81,13,17,25,64,16,22,3,30,33,30,14,1,11,41,117
Villanova9,9,Jermaine Samuels,FR,F,Villanova,Big East,21,143,7,26,4,11,3,15,9,14,6,22,28,7,1,3,10,22,26
Villanova10,10,Tim Delaney,SO,F,Villanova,Big East,17,43,0,3,0,1,0,2,0,0,1,3,4,2,0,0,1,12,0
Villanova11,11,Tom Leibig,SR,F,Villanova,Big East,12,18,1,5,1,1,0,4,0,0,0,2,2,0,1,0,1,0,2
Villanova12,12,Denny Grace,SR,G,Villanova,Big East,12,16,1,3,0,0,1,3,0,0,1,4,5,0,0,0,2,3,3
Villanova13,13,Matt Kennedy,SR,G,Villanova,Big East,10,14,1,1,1,1,0,0,0,0,0,3,3,0,0,1,0,1,2
Villanova14,14,Peyton Heck,JR,G,Villanova,Big East,9,13,0,1,0,0,0,1,0,0,1,1,2,0,0,0,0,0,0
Virginia1,1,Devon Hall,SR,G,Virginia,ACC,33,1063,131,282,74,156,57,126,76,85,12,130,142,106,29,5,35,45,395
Virginia2,2,Kyle Guy,SO,G,Virginia,ACC,33,1062,171,418,88,208,83,210,41,49,12,72,84,49,33,1,40,39,466
Virginia3,3,Ty Jerome,SO,G,Virginia,ACC,33,1007,127,300,71,156,56,144,37,41,11,92,103,130,51,1,51,75,347
Virginia4,4,Isaiah Wilkins,SR,F,Virginia,ACC,33,912,80,164,78,149,2,15,34,45,66,140,206,52,39,49,29,71,196
Virginia5,5,De'Andre Hunter,,G,Virginia,ACC,33,657,104,213,83,158,21,55,74,98,38,79,117,36,19,13,31,60,303
Virginia6,6,Jack Salt,JR,C,Virginia,ACC,33,652,52,80,52,80,0,0,13,32,50,82,132,9,11,22,21,62,117
Virginia7,7,Mamadi Diakite,SO,F,Virginia,ACC,33,508,73,128,73,128,0,0,30,38,31,67,98,5,15,15,24,72,176
Virginia8,8,Nigel Johnson,SR,G,Virginia,ACC,30,488,52,135,37,89,15,46,23,38,2,46,48,50,22,1,24,17,142
Virginia9,9,Jay Huff,FR,F,Virginia,ACC,12,105,17,25,15,18,2,7,5,8,6,17,23,4,1,14,4,14,41
Virginia10,10,Marco Anthony,FR,G,Virginia,ACC,13,103,10,28,5,15,5,13,1,3,1,12,13,9,2,2,6,5,26
Virginia11,11,Trevon Gross Jr.,JR,G,Virginia,ACC,10,27,2,3,2,2,0,1,0,2,1,3,4,3,1,0,1,2,4
Virginia12,12,Justice Bartley,JR,G,Virginia,ACC,10,22,2,5,1,3,1,2,1,2,2,2,4,0,0,0,1,1,6
Virginia13,13,Austin Katstra,FR,F,Virginia,ACC,10,19,4,7,3,3,1,4,1,2,0,5,5,0,1,0,1,1,10
Virginia Commonwealth1,1,Justin Tillman,SR,F,Virginia Commonwealth,A-10,33,1010,248,445,221,363,27,82,102,156,109,218,327,15,11,34,56,78,625
Virginia Commonwealth2,2,De'Riante Jenkins,,G,Virginia Commonwealth,A-10,33,973,149,344,70,155,79,189,48,64,26,97,123,83,44,7,81,64,425
Virginia Commonwealth3,3,Jonathan Williams,SR,G,Virginia Commonwealth,A-10,32,935,90,226,72,169,18,57,98,125,9,71,80,182,43,4,69,41,296
Virginia Commonwealth4,4,Malik Crowfield,SO,G,Virginia Commonwealth,A-10,29,697,54,152,8,24,46,128,14,18,4,35,39,44,23,4,24,48,168
Virginia Commonwealth5,5,Issac Vann,SO,F,Virginia Commonwealth,A-10,25,648,94,221,72,135,22,86,34,48,22,74,96,33,24,9,38,54,244
Virginia Commonwealth6,6,Mike'l Simms,,G,Virginia Commonwealth,A-10,33,571,70,171,36,67,34,104,15,23,14,54,68,37,24,2,27,49,189
Virginia Commonwealth7,7,Sean Mobley,FR,F,Virginia Commonwealth,A-10,33,558,50,124,20,45,30,79,18,20,20,80,100,56,12,3,41,75,148
Virginia Commonwealth8,8,Khris Lane,SR,F,Virginia Commonwealth,A-10,33,481,91,162,79,129,12,33,33,54,41,83,124,20,9,8,45,47,227
Virginia Commonwealth9,9,Marcus Santos-Silva,FR,F,Virginia Commonwealth,A-10,33,323,46,86,46,86,0,0,10,25,34,66,100,9,3,17,26,52,102
Virginia Commonwealth10,10,Tyler Maye,FR,G,Virginia Commonwealth,A-10,32,238,17,46,15,39,2,7,8,15,3,13,16,16,11,1,16,26,44
Virginia Commonwealth11,11,Xavier Jackson,JR,G,Virginia Commonwealth,A-10,20,166,8,25,4,12,4,13,5,6,3,15,18,10,3,1,8,10,25
Virginia Commonwealth12,12,Lewis Djonkam,FR,F,Virginia Commonwealth,A-10,20,69,4,11,4,11,0,0,6,12,5,3,8,2,2,3,4,17,14
Virginia Commonwealth13,13,Dylan Sheehy-Guiseppi,FR,G,Virginia Commonwealth,A-10,4,6,0,0,0,0,0,0,0,0,0,0,0,3,1,0,0,0,0
Virginia Military Institute1,1,Bubba Parham,FR,G,Virginia Military Institute,Southern,30,895,145,363,87,188,58,175,91,114,12,89,101,74,24,0,83,67,439
Virginia Military Institute2,2,Austin Vereen,JR,G,Virginia Military Institute,Southern,30,814,95,264,35,89,60,175,63,79,32,109,141,31,32,12,39,56,313
Virginia Military Institute3,3,Keith Smith,SO,G,Virginia Military Institute,Southern,29,775,72,187,41,110,31,77,27,43,6,65,71,90,40,5,69,49,202
Virginia Military Institute4,4,Garrett Gilkeson,SO,G,Virginia Military Institute,Southern,30,686,60,167,42,97,18,70,33,42,27,92,119,39,37,1,38,62,171
Virginia Military Institute5,5,Tyler Creammer,SO,F,Virginia Military Institute,Southern,30,591,86,190,86,189,0,1,42,59,59,103,162,19,13,16,41,69,214
Virginia Military Institute6,6,Jordan Ratliffe,FR,G,Virginia Military Institute,Southern,27,471,72,185,49,100,23,85,29,39,23,42,65,20,20,1,41,37,196
Virginia Military Institute7,7,Fred Iruafemi,SR,F,Virginia Military Institute,Southern,30,469,31,61,31,61,0,0,11,22,43,67,110,12,23,40,30,87,73
Virginia Military Institute8,8,Will Miller,SO,F,Virginia Military Institute,Southern,29,372,34,70,27,47,7,23,5,12,13,31,44,10,11,3,19,38,80
Virginia Military Institute9,9,Greg Parham,FR,G,Virginia Military Institute,Southern,29,338,32,90,23,46,9,44,16,19,3,28,31,38,14,1,25,23,89
Virginia Military Institute10,10,Sarju Patel,FR,G,Virginia Military Institute,Southern,30,326,27,79,10,34,17,45,11,15,6,30,36,14,3,1,23,20,82
Virginia Military Institute11,11,Myles Lewis,FR,F,Virginia Military Institute,Southern,25,236,32,70,30,61,2,9,22,30,16,30,46,5,3,6,18,26,88
Virginia Military Institute12,12,Tragen Fahl,FR,F,Virginia Military Institute,Southern,6,14,2,2,2,2,0,0,0,0,0,2,2,0,1,1,1,1,4
Virginia Military Institute13,13,Ta'Vonne Bond,,G,Virginia Military Institute,Southern,7,13,0,1,0,1,0,0,3,3,0,1,1,3,0,0,4,4,3
Virginia Tech1,1,Justin Robinson,JR,G,Virginia Tech,ACC,32,990,144,315,94,190,50,125,105,136,23,66,89,178,38,2,81,71,443
Virginia Tech2,2,Justin Bibbs,SR,G,Virginia Tech,ACC,30,981,149,306,86,145,63,161,33,45,4,70,74,48,19,5,34,46,394
Virginia Tech3,3,Ahmed Hill,JR,G,Virginia Tech,ACC,32,820,126,258,62,102,64,156,31,42,17,79,96,30,12,2,25,45,347
Virginia Tech4,4,Kerry Blackshear Jr.,JR,F,Virginia Tech,ACC,32,814,136,244,121,195,15,49,116,154,56,138,194,40,26,29,48,97,403
Virginia Tech5,5,Nickeil Alexander-Walker,FR,G,Virginia Tech,ACC,32,812,119,264,64,124,55,140,44,59,23,102,125,46,28,18,51,49,337
Virginia Tech6,6,Chris Clarke,JR,F,Virginia Tech,ACC,32,793,100,175,87,143,13,32,52,80,34,173,207,96,30,4,73,54,265
Virginia Tech7,7,Devin Wilson,SR,G,Virginia Tech,ACC,32,517,35,65,31,48,4,17,20,41,7,55,62,56,14,2,19,54,94
Virginia Tech8,8,P.J. Horne,FR,F,Virginia Tech,ACC,27,307,47,77,45,71,2,6,27,40,28,35,63,2,3,7,17,39,123
Virginia Tech9,9,Wabissa Bede,FR,G,Virginia Tech,ACC,27,222,21,46,13,30,8,16,11,18,4,20,24,21,7,3,9,22,61
Virginia Tech10,10,Tyrie Jackson,SO,G,Virginia Tech,ACC,27,199,24,57,18,33,6,24,27,37,11,30,41,11,7,1,15,22,81
Virginia Tech11,11,Nicholas Fullard,SR,F,Virginia Tech,ACC,9,14,0,1,0,1,0,0,0,2,0,1,1,0,0,0,2,3,0
Virginia Tech12,12,Justin Ammerman,JR,G,Virginia Tech,ACC,7,7,0,3,0,2,0,1,3,7,0,0,0,0,0,0,2,0,3
Wagner1,1,JoJo Cooper,SR,G,Wagner,NEC,32,1171,155,368,117,271,38,97,116,157,37,132,169,200,48,1,105,68,464
Wagner2,2,Blake Francis,SO,G,Wagner,NEC,31,1010,174,404,76,160,98,244,84,105,20,40,60,54,51,1,48,80,530
Wagner3,3,Romone Saunders,,G,Wagner,NEC,24,755,128,295,80,162,48,133,45,65,42,109,151,46,29,7,50,62,349
Wagner4,4,Devin Liggeons,JR,G,Wagner,NEC,32,698,74,161,53,94,21,67,42,56,50,99,149,28,17,17,39,77,211
Wagner5,5,Elijah Davis,JR,G,Wagner,NEC,32,646,78,195,63,129,15,66,59,73,40,99,139,24,21,11,53,66,230
Wagner6,6,AJ Sumbry,JR,F,Wagner,NEC,32,621,69,149,69,149,0,0,65,117,85,123,208,16,12,57,44,108,203
Wagner7,7,Nigel Jackson,FR,F,Wagner,NEC,25,421,49,130,20,45,29,85,14,17,34,60,94,20,10,16,28,77,141
Wagner8,8,Chase Freeman,FR,G,Wagner,NEC,31,406,24,56,14,25,10,31,30,36,7,30,37,32,11,1,18,36,88
Wagner9,9,Shack Scott,,F,Wagner,NEC,24,294,34,55,34,55,0,0,9,15,16,38,54,2,2,7,7,58,77
Wagner10,10,Tyler Plummer,FR,G,Wagner,NEC,18,227,13,36,10,24,3,12,6,19,13,15,28,6,7,2,12,21,35
Wagner11,11,Nick Madray,SR,F,Wagner,NEC,9,102,8,26,7,22,1,4,8,10,7,19,26,3,1,5,10,31,25
Wagner12,12,Jamar Brown,FR,F,Wagner,NEC,11,74,12,16,12,16,0,0,12,20,9,8,17,0,2,3,10,26,36
Wake Forest1,1,Bryant Crawford,JR,G,Wake Forest,ACC,31,987,164,397,107,238,57,159,138,159,12,79,91,152,48,5,101,74,523
Wake Forest2,2,Doral Moore,JR,C,Wake Forest,ACC,31,790,153,222,153,222,0,0,38,83,98,192,290,9,11,61,39,90,344
Wake Forest3,3,Brandon Childress,SO,G,Wake Forest,ACC,30,786,86,227,47,124,39,103,62,74,13,67,80,109,29,1,61,63,273
Wake Forest4,4,Keyshawn Woods,JR,G,Wake Forest,ACC,28,719,118,269,81,170,37,99,60,71,15,55,70,53,22,0,45,52,333
Wake Forest5,5,Mitchell Wilbekin,SR,G,Wake Forest,ACC,27,714,73,185,22,65,51,120,34,42,10,53,63,39,17,0,19,49,231
Wake Forest6,6,Chaundee Brown,FR,G,Wake Forest,ACC,30,628,88,214,61,135,27,79,25,31,27,64,91,34,7,5,37,42,228
Wake Forest7,7,Terrence Thompson,SR,F,Wake Forest,ACC,31,506,37,105,29,88,8,17,25,45,52,69,121,8,20,2,26,50,107
Wake Forest8,8,Olivier Sarr,FR,C,Wake Forest,ACC,30,453,32,92,26,68,6,24,27,45,30,59,89,11,10,21,32,76,97
Wake Forest9,9,Donovan Mitchell,SO,F,Wake Forest,ACC,30,338,31,64,16,29,15,35,10,13,14,53,67,6,9,8,19,60,87
Wake Forest10,10,Melo Eggleston,FR,G,Wake Forest,ACC,21,105,7,20,7,17,0,3,7,13,6,18,24,4,3,2,4,12,21
Wake Forest11,11,Sunday Okeke,FR,F,Wake Forest,ACC,20,94,5,10,5,10,0,0,1,2,15,13,28,4,4,3,6,26,11
Wake Forest12,12,Sam Japhet-Mathias,SO,C,Wake Forest,ACC,6,44,3,5,3,5,0,0,0,0,5,3,8,0,0,0,3,8,6
Wake Forest13,13,Troy Rike,,F,Wake Forest,ACC,9,12,3,7,2,4,1,3,0,0,0,0,0,1,0,0,1,0,7
Wake Forest14,14,Aaron Spivey,,G,Wake Forest,ACC,10,9,1,2,1,1,0,1,1,3,0,0,0,0,1,0,0,1,3
Wake Forest15,15,Britton Anderson,,G,Wake Forest,ACC,7,8,0,4,0,3,0,1,2,2,0,4,4,0,0,1,0,1,2
Wake Forest16,16,Anthony Bilas,,G,Wake Forest,ACC,8,7,0,3,0,3,0,0,0,0,4,1,5,2,0,0,1,0,0
Washington1,1,David Crisp,JR,G,Washington,Pac-12,32,1105,128,336,77,159,51,177,68,101,16,69,85,100,40,2,75,57,375
Washington2,2,Jaylen Nowell,FR,G,Washington,Pac-12,32,1032,189,421,155,319,34,102,94,119,32,95,127,85,36,8,79,94,506
Washington3,3,Matisse Thybulle,JR,G,Washington,Pac-12,32,1024,128,296,73,145,55,151,38,53,27,64,91,81,91,46,70,72,349
Washington4,4,Noah Dickerson,JR,F,Washington,Pac-12,32,861,166,294,164,289,2,5,158,201,89,181,270,27,23,18,73,107,492
Washington5,5,Dominic Green,JR,F,Washington,Pac-12,30,610,51,122,12,32,39,90,25,35,13,46,59,17,6,11,12,44,166
Washington6,6,Sam Timmins,SO,F,Washington,Pac-12,32,589,52,91,52,91,0,0,32,55,49,103,152,8,14,32,39,83,136
Washington7,7,Hameir Wright,FR,F,Washington,Pac-12,31,473,31,80,21,45,10,35,13,32,18,70,88,21,12,32,25,61,85
Washington8,8,Nahziah Carter,FR,F,Washington,Pac-12,32,449,55,121,41,81,14,40,34,55,15,40,55,17,25,9,32,49,158
Washington9,9,Carlos Johnson,SO,G,Washington,Pac-12,17,144,25,44,23,38,2,6,13,22,6,18,24,3,3,1,12,21,65
Washington10,10,Michael Carter III,FR,G,Washington,Pac-12,16,128,7,28,4,15,3,13,5,8,3,7,10,7,4,3,6,8,22
Washington11,11,Dan Kingma,SR,G,Washington,Pac-12,8,38,3,7,1,3,2,4,2,4,1,1,2,4,1,0,2,3,10
Washington12,12,Greg Bowman,SR,F,Washington,Pac-12,6,15,4,5,4,5,0,0,0,0,4,3,7,0,0,0,0,1,8
Washington13,13,Jason Crandall,SO,G,Washington,Pac-12,3,7,2,3,1,2,1,1,0,0,2,0,2,1,0,0,0,0,5
Washington State1,1,Malachi Flynn,SO,G,Washington State,Pac-12,31,1035,162,392,85,164,77,228,88,104,22,85,107,132,48,2,66,56,489
Washington State2,2,Viont'e Daniels,,G,Washington State,Pac-12,31,989,92,199,21,43,71,156,24,31,16,55,71,61,15,3,29,51,279
Washington State3,3,Robert Franks,JR,F,Washington State,Pac-12,30,989,175,368,109,205,66,163,105,123,49,148,197,58,15,29,70,85,521
Washington State4,4,Drick Bernstine,SR,F,Washington State,Pac-12,29,810,91,178,91,178,0,0,19,35,53,146,199,77,35,19,68,80,201
Washington State5,5,Carter Skaggs,SO,G,Washington State,Pac-12,31,634,86,201,17,30,69,171,16,18,16,65,81,17,5,0,28,45,257
Washington State6,6,Milan Acquaah,FR,G,Washington State,Pac-12,30,527,52,134,37,77,15,57,27,50,6,48,54,58,17,1,70,61,146
Washington State7,7,Kwinton Hinson,JR,G,Washington State,Pac-12,28,381,41,105,24,53,17,52,9,20,14,49,63,18,7,4,28,56,108
Washington State8,8,Jeff Pollard,SO,F,Washington State,Pac-12,27,336,40,72,40,68,0,4,18,27,15,32,47,10,3,3,17,21,98
Washington State9,9,Arinze Chidom,FR,F,Washington State,Pac-12,28,280,36,85,19,46,17,39,16,21,14,48,62,11,15,3,17,47,105
Washington State10,10,Steven Shpreyregin,SR,G,Washington State,Pac-12,15,114,11,33,2,4,9,29,2,3,1,5,6,1,1,0,2,10,33
Washington State11,11,Davante Cooper,JR,F,Washington State,Pac-12,19,113,11,17,11,17,0,0,3,11,4,18,22,5,2,7,10,19,25
Washington State12,12,KJ Langston,JR,G,Washington State,Pac-12,9,26,2,8,2,2,0,6,0,1,0,0,0,1,0,0,0,1,4
Washington State13,13,Jamar Ergas,FR,G,Washington State,Pac-12,10,16,2,3,2,3,0,0,0,0,0,1,1,1,0,0,2,0,4
Weber State1,1,Jerrick Harding,SO,G,Weber State,Big Sky,31,1019,249,470,192,336,57,134,127,144,19,87,106,53,33,5,74,57,682
Weber State2,2,Ryan Richardson,SR,G,Weber State,Big Sky,31,1010,145,316,54,103,91,213,38,51,7,93,100,66,33,11,46,69,419
Weber State3,3,Zach Braxton,JR,F,Weber State,Big Sky,30,840,133,240,133,239,0,1,102,154,52,181,233,40,10,31,39,82,368
Weber State4,4,Michal Kozak,FR,F,Weber State,Big Sky,31,812,55,130,36,68,19,62,40,47,35,116,151,31,12,17,42,73,169
Weber State5,5,Dusty Baker,SR,G,Weber State,Big Sky,31,789,64,140,20,47,44,93,51,57,6,120,126,115,24,3,41,47,223
Weber State6,6,Brekkott Chapman,JR,F,Weber State,Big Sky,27,734,103,227,62,130,41,97,45,60,20,141,161,38,24,45,64,94,292
Weber State7,7,Ricky Nelson,FR,G,Weber State,Big Sky,31,600,40,91,29,63,11,28,45,63,8,28,36,62,17,0,23,55,136
Weber State8,8,Jordan Dallas,SO,C,Weber State,Big Sky,22,188,21,33,20,31,1,2,7,13,4,27,31,5,2,5,15,32,50
Weber State9,9,Trevon Ary-Turner,FR,G,Weber State,Big Sky,18,185,23,48,10,17,13,31,7,11,0,16,16,12,1,1,13,24,66
Weber State10,10,Riley Court,FR,G,Weber State,Big Sky,12,61,5,14,4,8,1,6,0,1,1,10,11,8,2,0,4,10,11
Weber State11,11,Brenden Morris,SO,F,Weber State,Big Sky,8,37,8,13,6,8,2,5,0,1,3,11,14,0,3,2,3,8,18
West Virginia1,1,Jevon Carter,SR,G,West Virginia,Big 12,34,1176,191,458,120,275,71,183,126,146,29,132,161,225,97,13,94,104,579
West Virginia2,2,Daxter Miles,SR,G,West Virginia,Big 12,33,946,147,328,93,168,54,160,82,111,43,52,95,106,42,0,49,99,430
West Virginia3,3,Sagaba Konate,SO,F,West Virginia,Big 12,33,843,141,278,141,278,0,0,73,92,79,171,250,20,14,109,38,96,355
West Virginia4,4,Lamont West,SO,F,West Virginia,Big 12,33,763,104,250,53,103,51,147,54,70,44,83,127,21,14,5,35,64,313
West Virginia5,5,Wesley Harris,SO,F,West Virginia,Big 12,34,709,59,158,33,75,26,83,47,63,42,84,126,13,22,13,35,85,191
West Virginia6,6,James Bolden,SO,G,West Virginia,Big 12,34,591,104,239,37,78,67,161,26,31,24,42,66,36,33,8,29,69,301
West Virginia7,7,Esa Ahmad,,F,West Virginia,Big 12,18,490,64,144,55,114,9,30,44,64,32,64,96,31,15,6,29,35,181
West Virginia8,8,Teddy Allen,FR,F,West Virginia,Big 12,32,369,80,175,77,151,3,24,47,65,40,46,86,18,12,0,29,54,210
West Virginia9,9,Chase Harler,SO,G,West Virginia,Big 12,30,331,18,59,6,20,12,39,6,7,7,15,22,24,13,3,8,32,54
West Virginia10,10,Maciej Bender,SO,F,West Virginia,Big 12,33,296,17,38,17,35,0,3,6,15,32,34,66,6,9,9,14,40,40
West Virginia11,11,Logan Routt,SO,F,West Virginia,Big 12,27,216,12,21,12,21,0,0,4,9,36,20,56,9,0,10,10,35,28
West Virginia12,12,D'Angelo Hunter,,F,West Virginia,Big 12,18,95,7,28,1,11,6,17,5,6,6,10,16,3,2,3,2,12,25
Western Carolina1,1,Deriece Parks,SR,G,Western Carolina,Southern,31,947,114,299,48,99,66,200,36,45,27,91,118,83,44,9,63,33,330
Western Carolina2,2,Marc Gosselin,JR,F,Western Carolina,Southern,31,843,104,225,77,152,27,73,37,48,60,142,202,45,34,19,59,90,272
Western Carolina3,3,Mike Amius,JR,F,Western Carolina,Southern,32,738,152,277,152,277,0,0,102,161,62,117,179,35,38,27,90,97,406
Western Carolina4,4,Matt Halvorsen,FR,G,Western Carolina,Southern,32,713,72,209,13,34,59,175,68,80,5,31,36,32,15,0,33,31,271
Western Carolina5,5,Devin Peterson,SR,G,Western Carolina,Southern,30,672,79,197,60,147,19,50,35,52,12,50,62,90,22,5,46,50,212
Western Carolina6,6,Desmond Johnson,FR,G,Western Carolina,Southern,31,488,46,120,37,91,9,29,23,41,14,53,67,48,39,3,54,49,124
Western Carolina7,7,Haboubacar Mutombo,SR,G,Western Carolina,Southern,30,399,33,104,27,77,6,27,4,13,32,39,71,15,9,2,15,18,76
Western Carolina8,8,Marcus Thomas,FR,G,Western Carolina,Southern,24,276,47,115,35,79,12,36,28,39,22,23,45,15,16,2,21,33,134
Western Carolina9,9,Maurice Smith,SO,G,Western Carolina,Southern,29,276,21,60,16,47,5,13,12,26,30,51,81,16,13,5,29,32,59
Western Carolina10,10,Ashley Williams,SR,F,Western Carolina,Southern,25,261,33,91,17,43,16,48,35,42,19,16,35,12,7,3,12,31,117
Western Carolina11,11,Onno Steger,SO,F,Western Carolina,Southern,27,247,23,63,13,29,10,34,2,11,7,17,24,9,9,3,15,25,58
Western Carolina12,12,Adam Sledd,SO,F,Western Carolina,Southern,31,211,28,59,28,59,0,0,4,10,24,14,38,6,2,5,7,35,60
Western Carolina13,13,Charlendez Brooks,SR,F,Western Carolina,Southern,29,202,6,23,6,23,0,0,1,2,10,18,28,15,2,9,11,24,13
Western Carolina14,14,Yalim Olcay,SO,F,Western Carolina,Southern,17,55,3,9,3,9,0,0,6,11,5,10,15,3,2,0,4,11,12
Western Carolina15,15,Jason McMillan,SO,G,Western Carolina,Southern,13,39,3,12,0,1,3,11,0,0,1,2,3,1,1,0,1,2,9
Western Carolina16,16,Devonte Fuller,SR,G,Western Carolina,Southern,12,34,10,22,8,15,2,7,15,16,2,9,11,2,1,0,2,0,37
Western Illinois1,1,Kobe Webster,FR,G,Western Illinois,Summit,28,935,165,383,106,222,59,161,57,73,10,106,116,97,20,3,63,44,446
Western Illinois2,2,Dalan Ancrum,SR,G,Western Illinois,Summit,28,892,133,299,85,171,48,128,66,78,23,124,147,51,28,10,62,48,380
Western Illinois3,3,C.J. Duff,SO,G,Western Illinois,Summit,28,883,84,215,49,111,35,104,23,29,7,49,56,27,18,2,26,54,226
Western Illinois4,4,Brandon Gilbeck,JR,C,Western Illinois,Summit,28,743,132,201,132,201,0,0,39,85,62,137,199,20,18,72,59,93,303
Western Illinois5,5,Isaac Johnson,FR,G,Western Illinois,Summit,27,567,81,187,67,144,14,43,47,62,17,108,125,23,15,3,39,44,223
Western Illinois6,6,De'Angelo Bruster,,G,Western Illinois,Summit,28,475,44,101,33,66,11,35,26,34,3,39,42,40,19,0,38,44,125
Western Illinois7,7,Jeremiah Usiosefe,SO,G,Western Illinois,Summit,15,356,27,60,11,18,16,42,23,26,3,60,63,24,6,4,16,26,93
Western Illinois8,8,Jalen Morgan,JR,F,Western Illinois,Summit,27,322,30,61,30,59,0,2,26,31,17,42,59,11,2,10,22,38,86
Western Illinois9,9,Charles Gavin,,F,Western Illinois,Summit,18,181,18,38,18,38,0,0,4,11,16,17,33,2,1,1,5,21,40
Western Illinois10,10,Lynrick Moxey,SR,G,Western Illinois,Summit,16,117,20,29,18,27,2,2,11,19,4,27,31,9,6,1,3,2,53
Western Illinois11,11,Jordan Hughes,,C,Western Illinois,Summit,19,105,9,14,9,14,0,0,2,4,6,21,27,0,2,1,0,9,20
Western Illinois12,12,Chris Snyder,,C,Western Illinois,Summit,5,39,1,4,1,3,0,1,0,0,0,7,7,1,0,2,0,5,2
Western Illinois13,13,Ryan Maas,JR,G,Western Illinois,Summit,6,39,4,11,1,3,3,8,0,0,1,3,4,1,0,0,2,2,11
Western Illinois14,14,Otis Dortch,JR,G,Western Illinois,Summit,5,21,1,4,1,3,0,1,2,4,0,1,1,2,1,0,2,2,4
Western Kentucky1,1,Darius Thompson,SR,G,Western Kentucky,CUSA,34,1230,164,350,111,206,53,144,96,133,21,127,148,162,54,17,59,59,477
Western Kentucky2,2,Taveion Hollingsworth,FR,G,Western Kentucky,CUSA,34,1173,152,312,116,215,36,97,106,136,26,86,112,63,34,5,62,63,446
Western Kentucky3,3,Justin Johnson,SR,F,Western Kentucky,CUSA,34,1165,209,408,167,310,42,98,61,112,79,246,325,42,27,23,53,61,521
Western Kentucky4,4,Lamonte Bearden,JR,G,Western Kentucky,CUSA,34,929,131,279,116,226,15,53,119,143,19,54,73,117,58,5,80,70,396
Western Kentucky5,5,Dwight Coleby,SR,F,Western Kentucky,CUSA,34,924,142,238,142,237,0,1,89,119,82,185,267,19,21,59,55,88,373
Western Kentucky6,6,Jake Ohmer,FR,G,Western Kentucky,CUSA,33,553,62,164,29,62,33,102,36,46,10,27,37,31,22,0,20,47,193
Western Kentucky7,7,Marek Nelson,FR,F,Western Kentucky,CUSA,34,340,37,70,32,56,5,14,18,35,16,43,59,8,8,9,25,43,97
Western Kentucky8,8,Josh Anderson,,G,Western Kentucky,CUSA,19,337,55,98,54,92,1,6,36,61,16,34,50,14,19,6,17,39,147
Western Kentucky9,9,Moustapha Diagne,,F,Western Kentucky,CUSA,16,101,5,19,5,16,0,3,1,3,7,21,28,1,2,0,15,18,11
Western Kentucky10,10,Tyler Miller,SR,G,Western Kentucky,CUSA,14,73,2,6,2,3,0,3,0,4,2,7,9,2,3,0,1,6,4
Western Michigan1,1,Thomas Wilder,SR,G,Western Michigan,MAC,32,1050,190,442,143,297,47,145,174,207,23,118,141,139,62,10,79,72,601
Western Michigan2,2,Bryce Moore,JR,G,Western Michigan,MAC,32,982,101,248,37,84,64,164,49,72,8,76,84,48,39,2,30,73,315
Western Michigan3,3,Josh Davis,JR,G,Western Michigan,MAC,32,881,125,263,83,147,42,116,51,75,63,140,203,39,27,21,47,76,343
Western Michigan4,4,Brandon Johnson,SO,F,Western Michigan,MAC,29,787,106,219,99,194,7,25,50,77,61,106,167,20,13,16,33,75,269
Western Michigan5,5,Drake LaMont,SR,C,Western Michigan,MAC,32,778,93,184,91,179,2,5,31,46,48,77,125,37,12,26,20,76,219
Western Michigan6,6,Reggie Jones,SO,G,Western Michigan,MAC,32,756,113,296,75,167,38,129,59,73,27,97,124,67,30,9,65,58,323
Western Michigan7,7,Seth Dugan,JR,C,Western Michigan,MAC,23,363,49,97,49,95,0,2,22,44,53,41,94,10,6,12,17,42,120
Western Michigan8,8,Jared Printy,SO,G,Western Michigan,MAC,29,229,17,40,4,6,13,34,10,11,1,14,15,9,1,0,5,18,57
Western Michigan9,9,Michael Flowers,FR,G,Western Michigan,MAC,23,199,23,50,11,25,12,25,21,30,5,19,24,11,5,0,13,17,79
Western Michigan10,10,Jarrin Randall,SO,G,Western Michigan,MAC,24,134,10,39,7,18,3,21,8,14,0,5,5,14,9,0,6,14,31
Western Michigan11,11,Adida Ikongshul,SO,F,Western Michigan,MAC,16,125,8,21,6,18,2,3,1,3,9,21,30,5,1,0,8,21,19
Western Michigan12,12,Jason Whitens,FR,G,Western Michigan,MAC,16,95,6,14,3,9,3,5,3,5,7,8,15,4,3,3,4,13,18
Western Michigan13,13,TJ Clifford,FR,F,Western Michigan,MAC,9,28,3,6,3,6,0,0,0,2,4,4,8,0,0,1,0,2,6
Western Michigan14,14,Kyle McDermed,FR,G,Western Michigan,MAC,9,18,1,7,1,3,0,4,0,0,0,1,1,2,1,0,0,2,2
Wichita State1,1,Landry Shamet,SO,G,Wichita State,AAC,31,979,151,302,67,119,84,183,80,97,13,86,99,158,23,5,63,58,466
Wichita State2,2,Rashard Kelly,SR,F,Wichita State,AAC,32,769,65,139,63,121,2,18,49,83,99,141,240,79,18,18,43,55,181
Wichita State3,3,Shaquille Morris,SR,C,Wichita State,AAC,32,758,170,307,152,262,18,45,91,125,52,125,177,44,18,51,46,77,449
Wichita State4,4,Conner Frankamp,SR,G,Wichita State,AAC,30,707,109,261,59,117,50,144,34,34,3,50,53,68,23,5,10,39,302
Wichita State5,5,Austin Reaves,SO,G,Wichita State,AAC,32,689,85,184,31,60,54,124,43,52,13,88,101,65,15,8,37,49,267
Wichita State6,6,Zach Brown,SR,F,Wichita State,AAC,31,635,46,112,21,35,25,77,30,37,28,67,95,57,20,6,37,73,147
Wichita State7,7,Darral Willis Jr.,SR,F,Wichita State,AAC,32,579,119,234,103,190,16,44,78,118,57,134,191,33,6,14,51,56,332
Wichita State8,8,Rauno Nurger,SR,C,Wichita State,AAC,32,437,57,110,49,83,8,27,24,34,30,60,90,15,5,13,13,54,146
Wichita State9,9,Markis McDuffie,,F,Wichita State,AAC,21,399,61,136,41,81,20,55,36,49,20,48,68,25,9,2,30,36,178
Wichita State10,10,Samajae Haynes-Jones,JR,G,Wichita State,AAC,24,263,45,109,31,77,14,32,24,35,4,21,25,30,6,0,18,24,128
Wichita State11,11,C.J. Keyser,SO,G,Wichita State,AAC,18,127,9,24,9,18,0,6,13,15,4,10,14,11,6,2,6,26,31
Wichita State12,12,Asbjorn Midtgaard,FR,C,Wichita State,AAC,8,49,5,10,5,10,0,0,1,2,3,14,17,0,1,2,3,7,11
Wichita State13,13,Kaelen Malone,JR,G,Wichita State,AAC,7,28,1,7,1,5,0,2,1,2,0,4,4,6,0,0,4,5,3
Wichita State14,14,Brett Barney,SO,C,Wichita State,AAC,6,14,5,7,5,7,0,0,0,0,0,1,1,1,0,0,0,1,10
Wichita State15,15,Brycen Bush,FR,G,Wichita State,AAC,4,9,1,1,0,0,1,1,0,0,0,1,1,0,0,0,2,1,3
Wichita State16,16,Jacob Herrs,FR,G,Wichita State,AAC,3,8,1,1,1,1,0,0,0,0,0,1,1,1,0,0,0,1,2
William & Mary1,1,David Cohn,SR,G,William & Mary,CAA,31,1114,144,272,95,157,49,115,103,113,9,83,92,207,50,0,83,59,440
William & Mary2,2,Justin Pierce,SO,G,William & Mary,CAA,31,980,163,325,116,212,47,113,83,105,63,204,267,75,28,19,56,66,456
William & Mary3,3,Connor Burchfield,SR,G,William & Mary,CAA,31,945,133,248,44,77,89,171,35,40,7,94,101,58,25,4,47,55,390
William & Mary4,4,Matt Milon,SO,G,William & Mary,CAA,31,941,134,276,57,96,77,180,58,63,11,73,84,35,19,5,35,52,403
William & Mary5,5,Nathan Knight,SO,F,William & Mary,CAA,31,890,206,358,195,322,11,36,150,195,58,165,223,69,18,61,83,103,573
William & Mary6,6,Paul Rowley,JR,F,William & Mary,CAA,30,584,63,144,15,35,48,109,11,19,8,63,71,31,11,21,27,81,185
William & Mary7,7,Oliver Tot,SR,G,William & Mary,CAA,31,347,14,31,10,21,4,10,14,18,7,25,32,42,10,6,20,46,46
William & Mary8,8,Cole Harrison,SR,F,William & Mary,CAA,27,174,27,51,27,51,0,0,9,13,13,27,40,7,1,3,13,36,63
William & Mary9,9,Luke Loewe,FR,G,William & Mary,CAA,27,141,10,23,8,16,2,7,9,14,6,8,14,14,2,1,9,17,31
William & Mary10,10,Jihar Williams,FR,G,William & Mary,CAA,15,110,10,41,2,10,8,31,3,7,0,9,9,6,6,5,2,8,31
William & Mary11,11,Omar Mostafa,SO,G,William & Mary,CAA,7,17,3,4,2,3,1,1,2,2,0,0,0,1,2,0,1,1,9
William & Mary12,12,Jamison Glover,,G,William & Mary,CAA,6,14,1,4,1,2,0,2,2,2,0,2,2,1,1,0,0,3,4
William & Mary13,13,Amir Shafi,,G,William & Mary,CAA,3,9,1,2,0,1,1,1,0,0,2,2,4,0,1,0,2,2,3
William & Mary14,14,Tommy Papas,,G,William & Mary,CAA,3,9,1,3,1,2,0,1,0,0,0,0,0,2,0,0,0,1,2
Winthrop1,1,Anders Broman,SR,G,Winthrop,Big South,31,970,118,278,45,84,73,194,75,88,10,76,86,58,35,4,27,67,384
Winthrop2,2,Bjorn Broman,JR,G,Winthrop,Big South,31,938,94,214,22,40,72,174,56,69,8,60,68,95,38,2,35,57,316
Winthrop3,3,Xavier Cooks,SR,G,Winthrop,Big South,30,894,194,385,173,319,21,66,108,161,64,199,263,108,30,64,98,72,517
Winthrop4,4,Josh Ferguson,SO,F,Winthrop,Big South,31,812,123,202,119,184,4,18,65,86,68,161,229,28,21,34,55,66,315
Winthrop5,5,Adam Pickett,JR,G,Winthrop,Big South,31,649,105,192,82,132,23,60,55,77,16,76,92,57,27,12,67,75,288
Winthrop6,6,Kyle Zunic,FR,F,Winthrop,Big South,26,489,62,145,30,59,32,86,22,29,3,31,34,33,15,3,38,32,178
Winthrop7,7,Jermaine Ukaegbu,JR,F,Winthrop,Big South,29,352,27,42,27,42,0,0,19,41,35,64,99,15,5,19,22,68,73
Winthrop8,8,Austin Awad,JR,F,Winthrop,Big South,30,311,43,118,7,13,36,105,8,10,16,45,61,5,5,2,12,35,130
Winthrop9,9,Charles Falden,FR,G,Winthrop,Big South,26,294,36,79,19,48,17,31,6,9,13,27,40,14,12,0,25,28,95
Winthrop10,10,Nych Smith,JR,G,Winthrop,Big South,14,264,32,84,26,65,6,19,29,42,0,23,23,30,16,1,21,19,99
Winthrop11,11,Mitch Hill,SR,F,Winthrop,Big South,24,63,6,16,0,1,6,15,0,0,5,12,17,4,4,1,4,4,18
Winthrop12,12,Tom Pupavac,FR,C,Winthrop,Big South,17,58,5,10,5,10,0,0,2,3,7,7,14,1,0,2,4,6,12
Winthrop13,13,Kellen Blake,SR,G,Winthrop,Big South,16,31,8,16,5,7,3,9,0,2,2,2,4,1,1,0,2,1,19
Winthrop14,14,Matt Erps,SR,G,Winthrop,Big South,15,29,2,4,2,4,0,0,4,4,1,4,5,5,1,0,8,4,8
Winthrop15,15,Freddy Poole,SR,F,Winthrop,Big South,11,24,3,5,1,2,2,3,1,2,1,2,3,1,0,0,2,2,9
Winthrop16,16,Raivis Scerbinskis,,F,Winthrop,Big South,9,22,1,11,0,1,1,10,0,0,2,1,3,0,1,0,1,3,3
Wisconsin1,1,Brad Davison,FR,G,Wisconsin,Big Ten,33,1028,124,306,64,137,60,169,90,110,10,67,77,83,40,1,59,109,398
Wisconsin2,2,Ethan Happ,JR,F,Wisconsin,Big Ten,33,1017,242,458,241,447,1,11,105,191,78,186,264,122,49,35,93,87,590
Wisconsin3,3,Khalil Iverson,JR,G,Wisconsin,Big Ten,33,1003,107,196,107,172,0,24,69,101,60,109,169,58,26,30,67,54,283
Wisconsin4,4,Brevin Pritzl,SO,G,Wisconsin,Big Ten,32,938,93,234,40,85,53,149,47,55,30,92,122,33,26,7,17,56,286
Wisconsin5,5,Aleem Ford,FR,F,Wisconsin,Big Ten,33,805,60,150,15,40,45,110,27,33,20,71,91,30,11,6,25,64,192
Wisconsin6,6,Nate Reuvers,FR,F,Wisconsin,Big Ten,28,466,58,152,46,105,12,47,20,24,19,36,55,22,7,26,29,67,148
Wisconsin7,7,D'Mitrik Trice,,G,Wisconsin,Big Ten,10,315,35,92,23,52,12,40,12,17,2,18,20,23,6,1,13,13,94
Wisconsin8,8,T.J. Schlundt,JR,G,Wisconsin,Big Ten,24,193,8,36,2,9,6,27,0,0,6,9,15,6,4,2,4,10,22
Wisconsin9,9,Kobe King,FR,G,Wisconsin,Big Ten,10,190,21,46,14,25,7,21,3,3,8,6,14,6,2,2,3,10,52
Wisconsin10,10,Alex Illikainen,JR,F,Wisconsin,Big Ten,25,170,7,18,1,6,6,12,0,3,9,13,22,10,0,3,4,17,20
Wisconsin11,11,Aaron Moesch,SR,F,Wisconsin,Big Ten,26,157,7,9,5,7,2,2,14,15,3,11,14,7,3,0,6,14,30
Wisconsin12,12,Charles Thomas IV,JR,F,Wisconsin,Big Ten,22,131,12,28,12,22,0,6,2,5,12,23,35,4,1,1,5,22,26
Wisconsin13,13,Andy Van Vliet,JR,F,Wisconsin,Big Ten,17,131,18,39,6,16,12,23,10,14,5,18,23,3,1,3,5,14,58
Wisconsin14,14,Walt McGrory,,G,Wisconsin,Big Ten,9,72,0,5,0,2,0,3,5,7,0,8,8,4,4,0,7,5,5
Wisconsin15,15,Matt Ferris,JR,G,Wisconsin,Big Ten,6,8,1,1,1,1,0,0,0,0,1,2,3,0,0,0,2,1,2
Wisconsin16,16,Michael Ballard,FR,G,Wisconsin,Big Ten,1,1,0,0,0,0,0,0,0,0,0,0,0,0,0,0,0,0,0
Wofford1,1,Fletcher Magee,JR,G,Wofford,Southern,33,1107,241,503,101,180,140,323,92,101,9,89,98,55,31,3,55,61,714
Wofford2,2,Storm Murphy,FR,G,Wofford,Southern,33,901,68,152,28,51,40,101,32,38,7,64,71,126,29,1,53,43,208
Wofford3,3,Nathan Hoover,SO,G,Wofford,Southern,33,884,119,283,53,117,66,166,54,65,14,71,85,45,22,2,35,39,358
Wofford4,4,Trevor Stumpe,SO,G,Wofford,Southern,28,749,102,220,56,113,46,107,56,64,35,81,116,59,23,3,41,76,306
Wofford5,5,Cameron Jackson,JR,F,Wofford,Southern,30,689,149,250,149,247,0,3,51,84,54,121,175,43,54,43,53,98,349
Wofford6,6,Matthew Pegram,JR,C,Wofford,Southern,33,503,69,155,63,140,6,15,35,43,34,70,104,25,15,11,30,72,179
Wofford7,7,Derrick Brooks,SR,G,Wofford,Southern,25,479,24,64,19,51,5,13,36,46,21,89,110,33,6,5,35,40,89
Wofford8,8,Keve Aluma,FR,F,Wofford,Southern,32,423,29,50,29,50,0,0,23,40,43,64,107,18,6,13,20,62,81
Wofford9,9,Donovan Theme-Love,SO,G,Wofford,Southern,33,413,19,59,4,15,15,44,13,21,0,50,50,61,20,2,30,43,66
Wofford10,10,Tray Hollowell,FR,G,Wofford,Southern,28,260,31,78,11,21,20,57,7,8,1,23,24,21,6,0,27,15,89
Wofford11,11,Dishon Lowery,SO,F,Wofford,Southern,14,85,8,13,8,13,0,0,9,12,4,14,18,4,1,2,4,9,25
Wofford12,12,Michael Manning Jr.,FR,C,Wofford,Southern,11,53,3,7,3,7,0,0,0,0,3,6,9,2,1,1,0,8,6
Wofford13,13,Bobby Perez,JR,G,Wofford,Southern,10,53,5,9,1,4,4,5,0,0,0,0,0,5,2,0,6,2,14
Wright State1,1,Grant Benzinger,SR,G,Wright State,Horizon,34,1183,155,389,63,148,92,241,95,107,46,136,182,41,25,6,37,80,497
Wright State2,2,Mark Hughes,JR,G,Wright State,Horizon,34,1071,107,260,45,83,62,177,59,71,9,98,107,101,39,8,56,82,335
Wright State3,3,Loudon Love,FR,C,Wright State,Horizon,34,946,181,341,181,340,0,1,77,142,103,229,332,37,27,34,81,92,439
Wright State4,4,Parker Ernsthausen,JR,C,Wright State,Horizon,34,771,65,144,59,112,6,32,43,59,32,56,88,56,18,11,40,67,179
Wright State5,5,Cole Gentry,,G,Wright State,Horizon,24,742,76,179,43,87,33,92,35,43,10,57,67,65,33,0,35,40,220
Wright State6,6,Jaylon Hall,FR,G,Wright State,Horizon,32,738,99,254,66,153,33,101,67,101,17,65,82,44,18,2,56,53,298
Wright State7,7,Everett Winchester,FR,F,Wright State,Horizon,32,678,86,187,86,181,0,6,81,114,42,79,121,36,12,9,54,66,253
Wright State8,8,Justin Mitchell,SR,G,Wright State,Horizon,16,443,68,157,64,138,4,19,38,54,23,90,113,50,31,5,59,40,178
Wright State9,9,Tye Wilburn,JR,G,Wright State,Horizon,19,176,12,29,10,24,2,5,14,19,8,29,37,16,18,0,11,15,40
Wright State10,10,Alan Vest,JR,G,Wright State,Horizon,13,69,4,12,3,7,1,5,2,2,4,10,14,4,1,0,4,4,11
Wright State11,11,Trey Stacey,SR,G,Wright State,Horizon,8,18,1,7,1,4,0,3,0,0,2,2,4,0,2,0,0,1,2
Wright State12,12,Adam Giles,JR,F,Wright State,Horizon,6,15,0,0,0,0,0,0,1,2,2,1,3,1,2,0,1,1,1
Wyoming1,1,Hayden Dalton,SR,F,Wyoming,MWC,33,1098,190,415,105,204,85,211,119,142,46,213,259,86,31,16,82,90,584
Wyoming2,2,Alan Herndon,SR,F,Wyoming,MWC,33,1054,145,283,100,149,45,134,56,92,30,157,187,66,27,72,44,78,391
Wyoming3,3,Justin James,JR,G,Wyoming,MWC,32,996,210,445,170,315,40,130,146,201,19,172,191,98,36,16,81,81,606
Wyoming4,4,Cody Kelley,SO,G,Wyoming,MWC,33,767,57,146,24,52,33,94,25,39,13,66,79,96,29,1,51,67,172
Wyoming5,5,Alexander Aka Gorski,SR,G,Wyoming,MWC,31,698,67,195,22,39,45,156,32,43,8,52,60,31,12,1,34,59,211
Wyoming6,6,Hunter Maldonado,FR,G,Wyoming,MWC,29,615,50,129,33,73,17,56,36,49,12,51,63,41,28,5,29,57,153
Wyoming7,7,Louis Adams,SR,G,Wyoming,MWC,31,586,90,188,67,134,23,54,98,139,19,62,81,45,20,8,58,90,301
Wyoming8,8,Ny Redding,JR,G,Wyoming,MWC,32,445,28,78,15,45,13,33,50,57,5,28,33,42,15,0,28,49,119
Wyoming9,9,Andrew Moemeka,SO,F,Wyoming,MWC,29,309,20,37,20,37,0,0,13,19,25,38,63,7,14,9,13,51,53
Wyoming10,10,Austin Mueller,FR,F,Wyoming,MWC,13,85,5,9,3,5,2,4,2,2,1,5,6,1,1,1,6,13,14
Wyoming11,11,Jordan Naughton,JR,F,Wyoming,MWC,9,71,8,14,8,14,0,0,2,3,2,9,11,0,1,1,3,8,18
Wyoming12,12,Brodricks Jones,SO,F,Wyoming,MWC,15,69,3,18,2,10,1,8,4,4,3,3,6,3,0,0,4,9,11
Wyoming13,13,Sam Averbuck,SO,G,Wyoming,MWC,10,31,0,2,0,1,0,1,0,0,0,3,3,2,1,0,3,2,0
Xavier1,1,Trevon Bluiett,SR,G,Xavier,Big East,33,1131,193,437,92,198,101,239,155,180,27,160,187,83,24,8,63,72,642
Xavier2,2,Quentin Goodin,SO,G,Xavier,Big East,33,981,102,228,84,167,18,61,69,85,9,89,98,162,30,6,74,65,291
Xavier3,3,J.P. Macura,SR,G,Xavier,Big East,32,949,129,281,87,160,42,121,91,108,42,99,141,96,44,12,62,68,391
Xavier4,4,Kaiser Gates,JR,F,Xavier,Big East,32,766,72,173,19,34,53,139,40,48,30,118,148,29,15,8,19,76,237
Xavier5,5,Naji Marshall,FR,F,Xavier,Big East,33,736,95,179,80,137,15,42,63,84,40,106,146,55,22,7,52,57,268
Xavier6,6,Kerem Kanter,SR,F,Xavier,Big East,33,531,129,225,113,177,16,48,69,88,42,105,147,16,9,9,28,42,343
Xavier7,7,Paul Scruggs,FR,G,Xavier,Big East,32,527,56,120,44,79,12,41,29,39,5,58,63,54,18,8,46,62,153
Xavier8,8,Sean O'Mara,,F,Xavier,Big East,33,494,93,155,93,155,0,0,49,61,42,66,108,33,11,22,29,46,235
Xavier9,9,Tyrique Jones,SO,F,Xavier,Big East,30,448,80,128,80,128,0,0,50,86,40,95,135,13,18,17,24,62,210
Xavier10,10,Elias Harden,FR,G,Xavier,Big East,16,99,4,16,3,8,1,8,2,2,0,3,3,7,2,0,6,7,11
Xavier11,11,Leighton Schrand,SO,G,Xavier,Big East,4,6,0,0,0,0,0,0,0,0,0,0,0,0,0,0,3,0,0
Xavier12,12,Matt Singleton,SR,F,Xavier,Big East,5,4,0,0,0,0,0,0,0,0,0,0,0,0,0,0,0,1,0
Xavier13,13,Nick Vanderpohl,FR,G,Xavier,Big East,3,3,0,0,0,0,0,0,0,0,0,0,0,1,0,0,0,0,0
Yale1,1,Miye Oni,SO,G,Yale,Ivy,29,952,156,385,99,199,57,186,69,92,26,147,173,105,27,20,81,82,438
Yale2,2,Blake Reynolds,JR,F,Yale,Ivy,30,851,132,271,100,158,32,113,24,35,43,123,166,73,28,7,59,77,320
Yale3,3,Trey Phills,JR,G,Yale,Ivy,31,825,104,200,84,133,20,67,72,101,44,89,133,58,33,22,46,57,300
Yale4,4,Alex Copeland,JR,G,Yale,Ivy,30,799,124,276,100,208,24,68,65,75,13,61,74,82,32,1,62,39,337
Yale5,5,Paul Atkinson,FR,F,Yale,Ivy,31,749,110,159,110,159,0,0,68,102,53,89,142,32,21,17,31,79,288
Yale6,6,Azar Swain,FR,G,Yale,Ivy,31,610,77,192,23,54,54,138,26,36,11,62,73,38,16,1,19,30,234
Yale7,7,Noah Yates,SR,F,Yale,Ivy,31,537,55,120,21,31,34,89,22,28,21,69,90,36,20,6,31,70,166
Yale8,8,Eric Monroe,SO,G,Yale,Ivy,31,526,41,102,16,26,25,76,13,15,5,44,49,61,17,4,43,41,120
Yale9,9,Wyatt Yess,FR,F,Yale,Ivy,22,181,13,33,12,27,1,6,16,31,13,31,44,11,5,8,10,35,43
Yale10,10,Jameel Alausa,FR,F,Yale,Ivy,15,75,8,24,7,19,1,5,12,17,9,8,17,3,1,3,7,16,29
Yale11,11,Eric Anderson,SR,F,Yale,Ivy,11,64,3,12,2,9,1,3,6,8,4,8,12,5,1,2,2,4,13
Yale12,12,Thomas Ryan,JR,F,Yale,Ivy,10,51,5,12,4,5,1,7,3,4,0,2,2,2,3,3,4,10,14
Yale13,13,Makai Mason,,G,Yale,Ivy,1,21,2,6,0,3,2,3,2,5,0,0,0,1,0,0,1,0,8
Yale14,14,Austin Williams,,F,Yale,Ivy,3,9,1,3,1,2,0,1,0,2,0,1,1,0,0,1,0,1,2
Youngstown State1,1,Cameron Morse,SR,G,Youngstown State,Horizon,32,1024,174,466,95,229,79,237,65,83,11,62,73,124,35,6,65,45,492
Youngstown State2,2,Braun Hartfield,SO,G,Youngstown State,Horizon,32,1018,154,361,106,224,48,137,79,127,45,93,138,84,54,26,78,81,435
Youngstown State3,3,Naz Bohannon,,F,Youngstown State,Horizon,32,933,93,226,87,200,6,26,38,66,108,151,259,44,23,5,52,84,230
Youngstown State4,4,Garrett Covington,,G,Youngstown State,Horizon,32,788,95,212,71,142,24,70,53,76,47,67,114,26,34,4,43,66,267
Youngstown State5,5,Devin Haygood,JR,F,Youngstown State,Horizon,31,609,90,166,90,165,0,1,24,46,60,79,139,19,11,37,51,110,204
Youngstown State6,6,Jaylen Benton,SR,G,Youngstown State,Horizon,32,500,77,186,41,96,36,90,22,36,19,35,54,64,34,2,44,66,212
Youngstown State7,7,Jeremiah Ferguson,SO,G,Youngstown State,Horizon,29,430,43,132,29,90,14,42,22,34,3,22,25,38,20,1,32,42,122
Youngstown State8,8,Tyree Robinson,JR,F,Youngstown State,Horizon,30,385,97,156,97,156,0,0,31,58,38,69,107,13,27,29,37,75,225
Youngstown State9,9,Michael Akuchie,FR,F,Youngstown State,Horizon,29,266,34,92,19,33,15,59,19,20,23,36,59,4,6,8,25,41,102
Youngstown State10,10,Noe Anabir,JR,F,Youngstown State,Horizon,25,243,23,41,23,41,0,0,13,25,21,27,48,13,7,5,16,42,59
Youngstown State11,11,Francisco Santiago,SR,G,Youngstown State,Horizon,8,100,7,21,2,6,5,15,2,3,2,8,10,9,5,0,6,7,21
Youngstown State12,12,Ryan Strollo,SR,G,Youngstown State,Horizon,13,63,6,21,0,2,6,19,0,1,2,6,8,2,2,0,3,2,18
Youngstown State13,13,Jacob Brown,FR,F,Youngstown State,Horizon,10,54,5,14,4,5,1,9,3,4,2,8,10,2,3,1,2,7,14
Youngstown State14,14,Alex Wilbourn,JR,C,Youngstown State,Horizon,4,14,0,4,0,4,0,0,0,4,2,2,4,1,0,1,1,2,0
Youngstown State15,15,Dan Ritter,FR,G,Youngstown State,Horizon,8,13,2,8,1,3,1,5,0,0,3,3,6,2,3,1,1,0,5
Youngstown State16,16,John Kirincic,SO,G,Youngstown State,Horizon,4,10,2,4,2,2,0,2,0,0,2,0,2,0,2,0,1,2,4